泉润 化妆品 渗透 保湿 洁面乳 柔肤水 嫩滑乳 精华霜 洁面 修护保湿	国产 任何肤质 保湿 修护 补水	修护保湿 精华霜
玛丽安娜 植物 蛋白 青春定格 面部 护肤 化妆品 套装 洗面乳 保湿补水 化妆品套装	干性 中性 油性 保湿 补水 国产	保湿补水 化妆品套装
七夕 情人节 礼物 口红 礼盒 限量 套装 8支 丝绒 限量 手提 霸气 8支装 限量套装	欧美 丝绒	丝绒 限量套装
宝石 唇膏 限量版 女生礼物 面口 红壳 套装 哑光 哑光 新年 限定 限量版 红壳套装	欧美 哑光雾面 红色	哑光雾面 红壳套装
护肤品 化妆品 花漾 青春 紧致 补水 保湿 凝时 套装 宣姿 花漾 青春 膜力 花漾 青春 水嫩乳 凝时套装	任何肤质 敏感性 干性 混合性 国产 控油平衡 深层清洁 保湿 补水	控油平衡 凝时套装
专柜 正品 口红 小羊皮 半哑光 丝绒 定制 唇膏 女友 勃艮第红 玫瑰 礼盒 礼袋	欧美 丝绒 红色	丝绒 唇膏
口红 气唇 保湿 温变 唇彩唇蜜 唇釉 滋润 保湿 彩妆 粉嫩紫	润泽镜面 中国大陆 红色	润泽镜面 口红
精华液 美白 祛斑 精华乳 淡化 色素 斑点 提亮 肤色 舒缓 紧致 斑特证	提亮肤色 细致毛孔 淡斑 舒缓镇静 美白 提拉紧致 国产 任何肤质	提亮肤色 精华液
三八 妇女节 礼物 真我 香水 烈艳 蓝金 口红 礼盒 真我 香水 蓝金	运动 花果香调 女士	花果香调 香水
鱼子酱 眼部 精华液 滋养 眼周 淡纹 黑眼圈 保湿 补水 眼袋 皱纹	补水 国产 任何肤质	补水 精华液
璀璨 星光 魅色 唇膏 丝绒 哑光 雾面 星空 极光 口红 持久 不易 掉色 防水 滋润 鱼色 佳琪 推荐 抖音 花子 口红 阳光	持久 丝绒 雾面 中国大陆 防水 哑光 滋润	丝绒 口红
绅度 古龙 香水 男士 香久 古龙水 男生 邂逅 浪漫 古龙水 咖啡	男士 木质香调 职场 聚会 日常	木质香调 香水
补水 温和 刺激 芦荟胶 祛痘 淡印 修复 补水 保湿 面霜 美白 学生 美白 祛痘 套装	进口 补水 任何肤质	补水 套装
香水小样 孤儿 大吉岭茶 柏林 少女 冥府 银色 山泉 事后 清晨 试用 私家 小调 尼罗河 花园 12ml一	东方香调 通用 送礼	东方香调 香水小样
泊泉雅 芦荟 补水 保湿 组合 面膜贴 爽肤水 精华霜 黑头 收缩 毛孔 保湿补水	保湿 补水 国产 干性	保湿补水 爽肤水
美容院 化妆品 效肤 隔离乳 效抗 防护霜 修护保湿	国产 任何肤质 干性 中性 混合性 保湿 修护 补水	修护保湿 隔离乳
口红 流光恒 彩小 红管 丝绒 雾面 哑光唇膏 持久 不沾杯 咬唇妆 豆沙色 南瓜 平价 学生 赤红 红管	哑光雾面 中国大陆	哑光雾面 口红
祖马龙 女士香水 沐浴露 香氛 凝胶 沐浴 香皂 香氛 精油皂 肥皂 情人节 礼物 罗勒 橙花 沐浴露	户外 情趣 女士 日常 职场	户外 香氛
蜜罐 金致 臻颜 花蜜 奢养 滋润 面霜 补水 保湿 紧致 滋润 抗皱 淡化 细纹 弹润 新年 礼物 花蜜 套^蜜 保湿滋润 套装	保湿 滋润 抗皱 补水 国产 任何肤质	保湿滋润 套装
李佳 琪力 东方 古韵 口红 润唇膏 哑光 女士 学生 滋润 持久 保湿 掉色 不沾杯 高贵 复古 中国风 正红色	持久 不沾杯 保湿 红色 哑光 润唇 滋润	不沾杯 口红
香水 女心 禁忌 香水 赫本 浓香 生日 礼物 女友 老婆 灿若 晨曦 淡香	送礼 聚会 约会 日常 女士 花香调	花香调 香水
妇女节 礼物 新款 水嫩 倍现 套装 水乳 护肤品 补水 保湿 白雀 化妆品 二四 礼盒 洁面 乳+ 保湿补水 倍现套装	保湿 提拉紧致 补水 国产 任何肤质	保湿补水 倍现套装
水凝 精华霜 清爽 保湿 补水 滋润 滋养面霜 补水霜 保湿霜 清爽 黏腻 芦荟 滋养 质地 轻盈 女士 1瓶 保湿补水	保湿 补水 国产 任何肤质	保湿补水 精华霜
三八 妇女节 礼物 mac/魅可 口红 姨妈 生日 礼物 永生 花礼盒		口红
秒杀 抢购 黑熊 家族 眼膜贴 黄金 眼膜 淡化 细纹 黑眼圈 眼袋 水凝胶 提拉 抗皱 熊猫 眼膜 赠品 钥匙扣	淡化细纹 进口 任何肤质 抗皱 猫眼	淡化细纹 眼膜
衡美 护肤品 套装 面膜 系列 草本 青天葵 化妆品 新生 滋养霜 护肤品套装	提亮肤色 提拉紧致 修护 补水 国产 任何肤质	提亮肤色 护肤品套装
抖音 网红 蜗牛 原液 乳液 补水 嫩肤 滋养 保湿乳 精华乳 水乳 面部 护理	国产 补水 任何肤质	补水 乳液
三八 妇女节 礼物 口红 套装 黑管 白管 豪华 礼盒 生日 礼物 女友 闺蜜 阿玛尼 唇膏 口红套装		口红套装
三八 妇女节 礼物 情人节 礼物 口红 礼盒 套装 套盒 丝绒 朋友 生日 礼物 口红 鹅蛋 护手霜 口红礼盒套装	泰国 丝绒	丝绒 口红礼盒套装
绝色 魅惑 金管 口红 唇膏	欧美 自然 红色	自然 口红
圣罗兰(ysl) 口红 小金条 小银 口红 哑光 雾面 唇膏 人间 蜜桃	欧美 自然 红色	自然 口红
彩妆 苏卡娜 萨尔玛 丝润 口红 学生 网红 颜九 平价 滋润 保湿 唇膏 焦糖橘	保湿 滋润	滋润 口红
三八 妇女节 礼物 莹亮 纯魅 唇膏 圆管 茄色 古红 口红 朋友 闺蜜 表白 礼物 樱桃 白兰		口红
今生 红樱桃 传奇 健康 唇膏 专柜 京东 口红 滋润 补水 变色 唇膏 不沾杯 掉色 持久 保湿 孕妇 小孩 可用 理由 退换	中国大陆 自然 红色	自然 口红
丝绒 空气 哑光 唇釉 不易 掉色 防水 番茄 葡萄 蜜桃 唇彩唇蜜 口红 学生 不沾杯 肉桂奶 茶色	哑光雾面 中国大陆 红色	哑光雾面 口红
小金条 口红 哑光 雾面 掉色 网红 学生 唇膏 夏季 保湿 朱砂橘 雅色	雾面 哑光 保湿	哑光 口红
亚光 口红 女士 学生 豆沙色 复古 红姨妈 不易 脱色 不易沾杯 保湿 滋润 润唇膏 口红笔 咬唇妆 魅力	中国大陆 红色	红色 口红
莉兹 星空 闪耀 小金钻 口红 网红 彩妆 持久 保湿 不易 脱色 豆沙色	持久 豆沙色 保湿	持久 口红
水酷 凝肌 瀑水霜 补水 保湿 滋润 面霜 保湿补水	保湿 补水 任何肤质 干性 国产	保湿补水 面霜
国货 彩妆 国风 口红 持久 保湿 防水 不易 脱色 学生 唇膏 平价 女生 番茄 焦糖色	持久 防水 保湿	持久 口红
丝绒 雾面 口红 滋润 保湿 防水 不沾杯 脱色 网红 彩妆 多色 红棕色	丝绒	丝绒 口红
纤美 靓白素 美容 大王 面部 护肤套装 化妆品 系列 靓白素 洗面奶 精华素 日霜 晚霜 隔离霜 保湿补水	混合性 保湿 补水 国产	保湿补水 护肤套装
平替 唇膏 持久 雕花 口红 脱色 滋润 奈佰 丽微 保湿 雾面 不易 任意 2支	持久 女士 雾面 保湿 滋润	持久 口红
收缩 毛孔 精华液 细小 修复 粗大 女士 祛痘 黑头 保湿 控油爽肤水 补水 提亮 化妆 安瓶 提拉紧致 3瓶 细致 套装 洗面奶 黑头 面膜 收缩 毛孔 细致套装	国产 控油平衡 提亮肤色 保湿 提拉紧致 任何肤质	控油平衡 细致套装
口红 999^烈艳 蓝金 唇膏 金属色 滋润款	欧美 哑光雾面 红色	哑光雾面 口红
第二 牛奶 爆奶霜 保湿 补水 滋润 清爽 美皙 白提亮 肤色 学生 男士 护肤 懒人 素颜 面霜 乳液 擦脸霜 抖音 同款 支持 理由 退换货	国产 任何肤质 提亮肤色 保湿 滋润 补水	提亮肤色 乳液
口红 唇釉 臻致 丝绒 哑光 女士 唇釉 套装 红管 唇膏 女友 情人 礼物 黑管 斩男 粉红 专柜 礼盒 唇釉套装	欧美 丝绒 红色	丝绒 唇釉套装
冻干粉 套盒 补水 保湿 淡化 痘印 滋润 修护 提亮 肤色 补水 保湿 滋养 保湿补水	细致毛孔 保湿 补水 国产 任何肤质	保湿补水 冻干粉
淮树 正品 金银花 清颜 套装 淡化 痘印 补水 修护 滋养 角质 痘痘 化妆品 祛痘 护肤品 美容院 套盒 面膜 槐树 官网 金银花 清颜 套装 冻干粉 保湿滋润	保湿 滋润 修护 补水 国产 任何肤质	保湿滋润 套装
闪电 发货 祛痘 淡印 补水 保湿 面部 肌肤 6件 套装 化妆品 芦荟胶 洗面奶 芦荟水 芦荟 护肤 6件套装	深层清洁 保湿 补水 国产 任何肤质	深层清洁 6件套装
素颜霜 护肤品 套装 正品 女士 学生 补水乳液 保湿 夏季 控油 化妆品 女士 夏天 洗面奶 乳+ 素颜霜 bb霜 浅肤色 面膜 护肤品套装	国产 任何肤质 控油平衡 保湿 补水	控油平衡 护肤品套装
美白 祛斑霜 女士 淡化 雀斑 斑老 年斑 补水 保湿 精华 面霜 素颜霜 套装 正品 洁面 滋润美白 素颜霜套装	国产 任何肤质 干性 中性 油性 细致毛孔 滋润 美白 补水	滋润美白 素颜霜套装
美茜儿 星空 口红 学生 平价 美国 小众 品牌 学生 牛血色 唇膏 红橙色 草莓色		口红
美国 深层 保湿 营养 鲜活 红石榴 焕采 精粹 爽肤水 洗面奶 女秋 补水套装 双融 乳液	进口 滋润 补水 任何肤质	滋润 补水套装
阿缇 美诗 烟酰胺 精华液 补水 保湿 美肤 白皙 黄提亮 肤色 改善 暗哑 小胖 面部 原液 男女	提亮肤色 细致毛孔 抗氧化 国产 干性 中性 油性 混合性	提亮肤色 精华液
怡丽丝尔 优悦 悦薇 珀翡 护肤品 套装 新漾 美肌 洗面奶 爽肤水 乳液 护肤品套装	进口 补水 任何肤质	补水 护肤品套装
新品 霜白 红2 套装 第三 装金 雪润 透红 化妆品 护肤品 祈颜 依祈 依祁 单霜	任何肤质 国产	任何肤质 套装
佳琪 口红 礼盒 枫叶红 套装 礼盒 限量版 红管 哑光唇膏 紫罗兰 红管 番茄红 枫叶红套装	泰国 哑光	哑光 枫叶红套装
皇后牌 珍珠膏 白金 臻养 神经 酰胺 抗皱 补水 保湿 收缩 毛孔 粉刺 抗痘 提拉 紧致 保湿 肤修 护面霜 男女 正常 规格	提亮肤色 保湿 提拉紧致 补水 国产 中性	提亮肤色 珍珠膏
中国风 唇釉 套盒 三色 礼盒 持久 防水 口红 套装 国货 宫韵 口红套装	持久 防水	持久 口红套装
小众 复古 磨砂 雾面 亚光 哑光 柔润唇膏 红管 口红 黑管 口红	磨砂 哑光 雾面 润唇	磨砂 口红
水漾 芯肌 补水 保湿 水乳 护肤品 套装 礼盒 女士 化妆品 套装 洁面 精华 眼霜 混合 油性 肌肤 水乳 护肤品套装	控油平衡 保湿 舒缓镇静 补水 国产 任何肤质	控油平衡 护肤品套装
复颜 抗皱 紧致 中年 女士 护肤品 套装 皱纹 淡化 斑点 细纹 水乳 日霜 晚霜 精华 收缩 毛孔 改善 暗沉 眼袋 眼霜 复颜 眼霜 小样 护肤品套装	细致毛孔 抗皱 提拉紧致 晒后修复 国产 任何肤质	抗皱 护肤品套装
祛痘膏 痘印 套装 产品 芦荟胶 痘疤 痘坑 淡化 痘痘 女士 青春 痘粉 精华 保湿滋润	国产 保湿 滋润 补水 任何肤质	保湿滋润 套装
东森 化妆品 面膜 护肤品 套盒 滨海 剌芹肌 活水	任何肤质 进口	任何肤质 面膜
六大 原液 补水 保湿 收缩 毛提亮 肤色 精华水 肌底液 玻尿酸原液 3支装	国产 淡斑 任何肤质	淡斑 肌底液
保湿 补水 嫩白 护肤品 套装 学生 青少年 少女 化妆品 透莹亮 洁面乳 柔肤水 护肤品套装	控油平衡 细致毛孔 深层清洁 保湿 舒缓镇静 美白 晒后修复 补水 国产 敏感性 干性 中性 油性 混合性 所有肤质	控油平衡 护肤品套装
韩国 精华 原液 面部精华 补水 保湿 细化 毛孔 痘提亮 肤色 保湿 原液 保湿补水	保湿 补水 进口 任何肤质	保湿补水 面部精华
薇比莉 红色 口红 色系 中毒色 吸血鬼 暗红色 暗黑系 黑色 口红 黑色 黑樱桃 元气 蜜桔	红色	红色 口红
百雀羚 草本 水嫩 倍现 系列 套装 护肤品 化妆品 柔滑 夜间 精华 面膜 系列套装		系列套装
普拉达 鸢尾花 香水 女士香水 礼物	通用 清新香调	清新香调 香水
限量 中性香水 活动 精神 青春 禁忌 燃情 淡香水 当红	通用 花香调	花香调 淡香水
美肌 蜗牛 系列 套装 精华 保湿 补水 修复 祛痘 白皙 蜗牛霜 正品 护肤品 洁面 肌水 保湿补水 系列套装	保湿 补水 国产 任何肤质	保湿补水 系列套装
黛茵美 水光 肌护 系列 水光 洁面乳	洁面 任何肤质 国产	洁面 洁面乳
苏秘 呼吸37 男士 套装 苏秘 男士 水乳套装 水乳霜 套装 男士 护肤 套盒 男士 礼盒 精英 男士 乳液 洗面奶 保湿补水 水乳霜套装	保湿 提拉紧致 补水 进口 任何肤质	保湿补水 水乳霜套装
国内 专柜 面霜 钥匙 臻焕颜 千熙 黑矅岩 水盈 调理乳 保湿补水	保湿 补水 进口 任何肤质	保湿补水 面霜
康俪美 护肤品 套装 化妆品 玻尿酸 精华液 护肤品套装	补水 国产 任何肤质	补水 护肤品套装
抖音 流沙 香水 女士 持久 淡香 费洛蒙 香水 柏林 少女 冥府 风铃 反转 巴黎 银色 山泉 香水 反转 巴黎	职场 休闲 约会 日常 木质香调 通用	木质香调 香水
美白精华液 正品 原液 补水 保湿 滋润 淡化 黑色素 提亮 肤色 改善 面部 沉温 滋养 收缩 毛孔 护肤品 男女 通用 3瓶 赠送 面膜 淡斑保湿	国产 淡斑 保湿 祛痘 补水 任何肤质	淡斑保湿 原液
暖春 口红 南瓜 学生 润唇 唇膏 组合 圣诞 套装 礼盒 正红 甜心 小姐香水 专柜 礼盒 圣诞套装	欧美 哑光雾面 红色	哑光雾面 圣诞套装
春季 新品 情挑 诱吻 银管 夹心 嘴唇 口红	欧美	欧美 口红
小金条 口红 礼盒 圆管 方管 土盒 限量 自组 装加 气垫 鳄皮 礼盒	泰国	泰国 口红
莱俪 墨恋 黑泽 男士 淡香水 墨恋 简装	送礼 聚会 约会 日常 男士 木质香调	木质香调 淡香水
琉光 唇釉 丝绒 哑光 持久 脱妆 唇彩唇蜜 口红 红棕	丝绒	丝绒 口红
韩国 直邮 小样 试用 装袋 旅行 套装 拱辰 天气 丹/津率 精华 面霜 面膜 水乳 小样 拱辰 气津 乳液 保湿补水 旅行套装	保湿 补水 进口 任何肤质	保湿补水 旅行套装
暖春 圆管 口红 方管 唇膏 小金条 黑管 生日 礼物 圆管 新色	欧美	欧美 口红
跨境 品牌 男士香水 优雅 自信 性感 古龙 花香 柑橘 香水 男士	男士 海洋香调 日常	海洋香调 香水
烈焰 迷惑 口红 持久 保湿 上色 不沾杯 唇釉 唇彩唇蜜 不易 褪色 防水 滋润 显色 姨妈	持久 不沾杯 显色 中国大陆 保湿 防水 滋润	不沾杯 口红
正品 祛痘 九红 益肤霜 三合 装祛痘 套装 粉刺 加强 装祛痘套装	国产 补水 任何肤质	补水 装祛痘套装
香水 邂逅 柔情 小姐 5号 淡浓 香粉 系列 淡香水	女士 淡香 聚会 日常 约会 职场	淡香 香水
京速 快递 经典 传奇 面霜 补水 保湿 滋润 舒缓 精华 面霜 保湿滋润	进口 保湿 滋润 补水 任何肤质	保湿滋润 面霜
网红 唇釉 不沾杯 防水 滋润 口红 掉色 保湿 可爱 学生 唇膏 抖音 颜九 5支 选择 联系 客服 备注	不沾杯 中国大陆 保湿 防水 滋润	不沾杯 口红
情人节 礼物 睫毛膏 bb霜 6色 唇釉 套装 掉色 不沾杯 防水 口红 学生 套装 超值 亏本 冲量 6支礼 盒装 睫毛膏 口红学生套装	哑光雾面 中国大陆 红色	哑光雾面 口红学生套装
面霜 雪润 皙白 晶澈 滋养霜 密集 修护 晚霜 嫩白 修护 补水 保湿 滋润 收缩 毛孔 护理 日晚霜 官方 旗舰 官网 雪润 皙白 晶澈 滋养霜	补水 国产 任何肤质	补水 面霜
反转 巴黎 女士香水 清新 自然 淡香 费洛蒙 花香 反转 巴黎	花果香调 女士 日常	花果香调 女士香水
智妍 精华 面霜 黄金 面霜 干燥 细纹 皱纹 松弛 暗沉 精华 滋养霜 日霜 正装 外盒 抗皱修护	抗皱 修护 提拉紧致 抗衰 进口 任何肤质 干性 中性 混合性	抗皱修护 面霜
三八 妇女节 礼物 可可 小姐 馥郁 香嘉 柏丽尔 香氛 男士 运动 香水 小样 朋友 柏丽 香水 其他	运动 男士 花果香调	花果香调 香水
礼盒 礼袋 祖马龙 香香 藤条 扩散 香氛 英国 小苍兰	休闲 日常 通用 花香调	花香调 香氛
赋原 修护 精华液 伊琳娜 淡红 舒缓 干红 肌肤 镇敏 修护 深度 补水 保湿 赋活 原液 修护保湿	任何肤质 敏感性 干性 混合性 保湿 舒缓镇静 修护 补水 国产	修护保湿 精华液
金致 臻颜 松露 奢养 肌活 女士 护肤套装 组合 原液	国产 深层清洁 保湿 提拉紧致 补水 任何肤质	深层清洁 护肤套装
口红 持久 保湿 脱色 防水 哑光 豆沙 唇彩 学生 可爱	哑光 持久 防水 保湿	持久 口红
口红 魅可 西柚 小辣椒 新色 牛血色 大红色	欧美 红色	红色 口红
5号 女士 淡香水 香精 5号 试管	淡香 日常 通用 香精 约会 职场	淡香 香精
口红 星钻 小灯 管礼 盒装 包装口 红豆 沙色 口红 正红色 蜜桃 珊瑚色	裸色豆沙色 闪光珠光 中国大陆	闪光珠光 口红
肽抗 皱紧 原液 补水 保湿精华液 淡化 细纹 收缩 毛孔 提亮 肤色 护肤 安瓶 原液 六胜肽 原液 抗皱补水	国产 保湿 抗皱 补水 任何肤质	抗皱补水 保湿精华液
官方 旗舰 正品 紫苏 玻尿酸 莹润 套盒 补水 保湿 提拉 紧致 提亮 面部 肌肤 护肤 紫苏 玻尿酸 莹润 保湿补水 套装	保湿 提拉紧致 补水 国产 任何肤质	保湿补水 套装
奢宠 修护 润肤霜 补水 保湿 滋润 舒缓 修复 面霜 嫩肤 学生 男女 通用 保湿滋润	保湿 滋润 修护 补水 国产 任何肤质	保湿滋润 面霜
傲宁 冷凝 舒尔丹 傲宁 冷凝胶 祛痘 青春 痘痘 坑痘 印痘 疤痤疮 祛痘膏 2送 适合 面部 痘痘 闭口 痘印 色素沉	祛痘 国产 任何肤质	祛痘 冷凝胶
旗舰 蘑菇 气垫bb霜 粉底液 遮瑕 防水 防汗 cc棒 持久 保湿 蘑菇 气垫霜 象牙色	持久 保湿 防汗 遮瑕 防水	遮瑕 气垫霜
圣诞 跨年 礼物 七夕节 礼物 美容院 护肤品 套装 补水 保湿 按摩膏 精华液 乳液 玻尿酸 院装 氨基酸 洁面乳 有泡 护肤品套装	提亮肤色 补水 国产 任何肤质	提亮肤色 护肤品套装
口红 新品 小粉管 彩唇膏 持妆 滋润 保湿 持久 不易 脱色 咬唇妆 专柜 同款 玫红色	持久 中国大陆 保湿 红色 滋润	滋润 口红
暖春 黑管 白管 唇膏 口红 套装 情人节 七夕 礼盒 音乐 玫瑰 礼盒 口红套装	欧美 润泽镜面 红色	润泽镜面 口红套装
面霜 乳液 男士 活力水 凝露 保湿补水	保湿 补水 进口 任何肤质	保湿补水 乳液
古龙 男士香水 持久 淡香 清新 男人 女士 香氛 少男 古龙	持久 淡香	持久 香氛
活酵母 面膜 面霜 身体乳 黄金面膜 苹果 肌线 专柜 胜肽 臻粹 系列 套装 面部 护肤套组 净妍 平衡 洁面 泡泡 系列套装	深层清洁 抗痘 国产 任何肤质	深层清洁 系列套装
专柜 正品 中国风 复古 水感 唇彩 套装 礼盒 滋润 唇釉 生日 礼物 女友 闺蜜 朋友 浆果色 唇彩套装	中国大陆 自然 红色	自然 唇彩套装
化妆品 套装 元江 芦荟高 补水 高山 植物 套装 护肤品 礼盒 精华液 保湿 提亮 紧致 元江 洁面 凝露 乳液 霜4 保湿补水 化妆品套装	国产 任何肤质 细致毛孔 保湿 提拉紧致 补水	保湿补水 化妆品套装
明珠 御颜 冻干粉 明珠御颜冻干粉	任何肤质 国产 补水	任何肤质 明珠御颜冻干粉
女王节 礼物 口红 丝绒 唇膏 礼盒 黑管 哑光 其它 颜色 盒装	欧美 哑光 丝绒	丝绒 口红
反转 巴黎 黑鸦片 女士香水 迪丽 热巴 失魂果 香水小样 反转 巴黎 其他	女士	女士 香水小样
韩国 直邮 菲诗小铺 调理 修护 紧致 系列 老化 紧致 肌肤 保湿 补水 老化水 乳液 面霜 精华 眼霜 抗皱保湿	进口 保湿 抗皱 提拉紧致 任何肤质	抗皱保湿 乳液
免邮 宝宝霜 袋装 温和 滋养 儿童 护肤面霜 保湿 补水 宝宝霜 1袋 保湿滋润	国产 保湿 滋润 补水 干性 中性 油性 混合性	保湿滋润 宝宝霜
暖春 香水 橙花 朱一龙 乌木 沉香 便携式 白麝香 其他	男士 花香调	花香调 香水
极光 玫瑰 口红 限量 国庆 限定 口红 彩虹 玫瑰 玫瑰色	玫瑰 中国大陆	玫瑰 口红
芦荟胶 补水 控油 痘印 芦荟膏 修复 保湿 面霜 芦荟 凝胶 芦荟胶 修护保湿	保湿 修护 抗痘 补水 国产 任何肤质	修护保湿 凝胶
sod蜜 保湿乳液 补水 滋润 身体 面部 护理 面霜 国货 精品 sod蜜 2瓶装	提亮肤色 保湿 提拉紧致 补水 国产 任何肤质	提亮肤色 面霜
乳液 古茶 男士 醒肤 活力 滋养乳 节水 平衡 有效 补水 修护乳 古茶 乳液 护肤品 专柜 正品 保湿滋润	国产 保湿 滋润 补水 任何肤质	保湿滋润 乳液
三八 妇女节 礼物 魅惑 口红 裸色 茄色 正红色 滋润 显色 美唇 护唇 生日 礼物 圣达菲	红色	红色 口红
口红 姨妈 丝绒 唇膏 限量版 生日 礼物 套装 覆盆子色 礼物套装	丝绒 中国大陆	丝绒 礼物套装
清痘 系列 组合 护肤品 化妆品 组合 套装 适合 油性 肌肤 问题 搭配 洁面 调理水 凝露 冻干粉 化妆品组合套装	油性 混合性 补水 国产	补水 化妆品组合套装
韩国 呼吸37度(sum:37) 套装 苏秘 呼吸套盒 惊喜 水分 水乳霜 礼盒 套装 补水 保湿 滋润 孕妇 可用 苏秘 时光 能量 肌底 水乳霜 专柜 水乳霜礼盒套装	进口 控油平衡 细致毛孔 保湿 补水 任何肤质 干性 油性 混合性	控油平衡 水乳霜礼盒套装
护肤品 套装 美白 补水 牛奶 雪肤焕白 护肤套装 保湿 化妆品 面部 护肤 深度 滋养 吸收 美白 洁面慕斯 水+乳 淡斑保湿 护肤品套装	进口 保湿 淡斑 美白 补水 任何肤质	淡斑保湿 护肤品套装
水能量 男士 持久 淡香水 大西洋 海韵 海马 男士 淡香水	海洋香调 通用 运动 休闲 约会	海洋香调 淡香水
流沙 香水 女士 持久 淡香 清新 私处 香水 异味 柏林 少女 蓝风铃 银色 山泉 可可款 流沙 冥府 银色 山泉	持久 淡香 通用 银色 职场 约会 日常	持久 香水
三八 妇女节 礼物 爱冲动 香色 随行 限定 礼盒 反转 巴黎 香水 测试 发货	男士 花香调 日常	花香调 香水
光彩 透白 系列 珍珠 光采 卸妆 凝胶 光采 洁肤乳 珍珠 光采 精华水 光采 透白 精华 光采 夜间 修护 精华 保湿滋润	进口 保湿 滋润 补水 任何肤质	保湿滋润 凝胶
圣诞 限量 金管 恒久 哑光唇膏 口红 定制 金管 唇膏 口红	泰国 哑光	哑光 口红
恒芳 变色 口红 保湿 滋润 唇膏唇彩 学生 草莓 香型	滋润 保湿	保湿 口红
暖春 口红 礼盒 套装 生日 圣诞节 生日 礼物 礼盒 桃红	欧美 哑光雾面 红色	哑光雾面 套装
三八 妇女节 礼物 小羊皮 口红 午夜 星空 朋友 生日 礼物 禁忌 玫瑰 礼盒	玫瑰 泰国	玫瑰 口红
臻白焕 采亮 肤乳液 保湿 补水 滋润 晶莹 水嫩 保湿补水	保湿 补水 国产 任何肤质	保湿补水 肤乳液
植物 净肤 精华 美颜霜 植物 霜玉 日霜 晚霜 微商 同款 5克	任何肤质 进口	任何肤质 晚霜
国珍 香兰阁 化妆品 系列 水乳霜 精华液 洁面 眼霜 面膜 护肤 专柜 抖音 李佳琦 推荐 焕颜 养肤 调理乳 保湿滋润	国产 保湿 滋润 补水 任何肤质	保湿滋润 面膜
绒情 迷雾 哑光 唇釉 持久 保湿 唇彩唇蜜 染唇液 滋润 口红 学生	哑光雾面 中国大陆 红色	哑光雾面 口红
魅惑 口红 唇膏 持久 保湿 补水 锁水 姨妈 搭配 备注 联系 客服	哑光雾面 中国大陆 红色	哑光雾面 口红
按压式 口红 保湿 持久 脱色 韩国 学生 防水 可爱 咬唇妆 哑光姨 妈色 不沾杯 掉色 滋润 唇彩 热吻红	持久 不沾杯 保湿 韩国 防水 哑光 滋润	不沾杯 口红
都彭 魅力 悠航 摩登 水手 男士香水	通用 花香调 日常	花香调 男士香水
牛奶 嫩肤 滋养 护肤品 组合 套装 清洁 控油 补水 保湿 提亮 肤色 收缩 毛孔 女士 化妆品 套装 滋润 水乳套装 洁面乳 保湿补水 护肤品组合套装	国产 任何肤质 细致毛孔 保湿 提拉紧致 补水	保湿补水 护肤品组合套装
新品 丝绒 出彩 美妆 口红 滋养 丰盈 雾面 梅花型 口红 唇彩	滋养 丰盈 雾面 丝绒	丝绒 口红
万宝龙 星辰 传奇 经典 男士香水 星际旅者	男士 木质香调	木质香调 男士香水
圣诞 礼物 女友 红管 口红 妈色 中秋节 礼物 套盒 女友 喜欢 礼物 哑光款 巧克力 玫瑰 礼盒	泰国 哑光 玫瑰	哑光 口红
舒博伦 澳洲 进口 适敏 保湿 维生素e 温和霜 夏季 面部 护肤品 金装 舒博伦 适敏 温和霜 保湿滋润	保湿 滋润 修护 补水 进口 任何肤质	保湿滋润 维生素e
三八 妇女节 礼物 花草 水语 淡香水 清新 自然 香调 迷人 香氛 樱花 薄荷 青草	女士 花香调 日常	花香调 香氛
水润 娇颜 贵妇 保湿乳 补水 滋润 收缩 毛孔 水嫩 细滑 乳液 护肤品 保湿滋润	保湿 滋润 修护 补水 国产 任何肤质	保湿滋润 乳液
男士 冰川 控油 补水套装 洁面膏 醒肤水 醒肤露 精华乳 保湿 补水 肤色 细致 毛孔 男士 护肤套装 化妆品 乳+露	国产 控油平衡 细致毛孔 补水 任何肤质	控油平衡 补水套装
奈佰 丽红 樱桃 健康 唇膏 保湿 变色 胡萝卜 口红 彩妆 樱桃素	橘色 中国大陆	橘色 口红
保证 品质 法国 蒂普 提克 香水 大溪 浓香 杜耶尔	清新香调 通用	清新香调 香水
口红 持久 保湿 不易 脱色 不沾杯 唇膏 防水 南瓜 姨妈 学生 持久 湿润 保湿 脱色 显色 礼物 女友 正品 非雕花 口红 枫糖色	持久 不沾杯 显色 保湿 防水	不沾杯 口红
浪漫 女士香水 橙花 莉香 持久 淡香 清新	聚会 休闲 约会 日常 女士 花香调	花香调 女士香水
韩国 思亲肤 黑石榴 莹润 化妆水 精华 乳液面霜 水乳套装 黑石榴 盈润 精华乳 保湿滋润	保湿 滋润 提拉紧致 进口 任何肤质	保湿滋润 水乳套装
纯色 唇釉 奢华 缎面 镜光 唇彩 口红 新色	欧美 自然 红色	自然 唇釉
小金条 口红 杨树林 哑光 雾面 唇膏 礼盒 套装 支装 唇膏礼盒套装	欧美 哑光雾面 红色	哑光雾面 唇膏礼盒套装
活泉 水动力 护肤礼盒 学生 温和 补水 保湿 护肤 化妆品 洗面奶 爽肤水 保湿乳霜 套装 保湿乳霜套装	保湿 补水 国产 任何肤质	补水 保湿乳霜套装
钻石 闪耀 钻石 口红 滋润 丝绒 哑光 持久 掉色 不沾杯 润唇膏 学生 浆果色 玫瑰 豆沙	持久 女士 不沾杯 丝绒 哑光 润唇 玫瑰 滋润	不沾杯 口红
专营店 正品 燕窝 沁白臻颜 套装 护肤品 洁面 水乳液 精华 保湿 滋润 乳液 沁白臻颜套装	国产 保湿 任何肤质	保湿 沁白臻颜套装
璀璨 磨坊 蓝风玲 香水 女士 金沙 香水 网红 持久 淡香 橙色 记忆	通用 花果香调 送礼	花果香调 香水
玫瑰 胭脂水 唇液 咬唇 掉色 不沾杯 口红液 唇膏 唇蜜 唇釉 保湿 滋润 唇颊 两用 胭脂水	不沾杯 中国大陆 保湿 玫瑰 滋润	不沾杯 唇液
百羚百萃 植物 草本 精华 护肤品 套装 清爽 温和 补水 保湿 滋润 黑头 改善 肤色 孕妇 化妆品 男女 润肌 赋活 面奶 保湿补水 护肤品套装	保湿 补水 国产 任何肤质	保湿补水 护肤品套装
香水 专柜版 先生 男士香水	女士	女士 男士香水
肽抗 皱紧 原液 胶原蛋白 玻尿酸 精华液 提拉 面部 淡化 细纹 皱纹 抬头 补水 保湿 男女 化妆 护肤品 六胜肽 精华 2瓶 优惠装	提亮肤色 细致毛孔 抗皱 提拉紧致 任何肤质 敏感性 干性 中性 国产	提亮肤色 精华液
玛丽佳人 磁扣 唇膏 保湿 滋润 唇部 护理 唇淡化 唇纹无色 女士 口红 豆沙 玫瑰	玫瑰 淡化唇纹 滋润 保湿	淡化唇纹 口红
护肤品 组合 套装 洁面乳 平衡乳 醒肤 水乳 气垫cc霜 面膜 修颜霜 洁面皂 补水 保湿 隔离 男女 洁面 妆前乳 醒肤水 平衡乳 面膜 护肤品组合套装	深层清洁 保湿 补水 国产 任何肤质	深层清洁 护肤品组合套装
礼盒 套装 冰泉 补水 控油 套装 夏季 保湿 水乳液 女士 冰泉 补水套装	混合性 国产 控油平衡 保湿 补水	控油平衡 补水套装
奢养 肌活 青春液 精华液 青春 乳能量 洗面奶 面膜 组合 面膜 1片 保湿补水	保湿 补水 国产 任何肤质	保湿补水 面膜
香水 女士 持久 淡香 学生 自然 山谷 百合 清新 喷雾 蓝风铃 熏衣草 网红 瓶装 付款 备注 香味	持久 淡香 香味 自然 喷雾	持久 香水
芯丝翠 柠檬 酸果酸 原液 净白 刷子	进口 补水 任何肤质	补水 原液
变色 唇膏 口红 学生 掉色 防水 润唇膏 滋润 保湿 唇部 打底	粉色 中国大陆 自然	自然 口红
专营店 京东 安维 肤油 传明 酸淡印 淡化 色素 紧致 防色 沉欣 修护液 欣安 修护液	提亮肤色 国产 中性	提亮肤色 修护液
梵贞 水嫩 修护 精华 肌底液 补水 润泽 原液 收缩 毛孔 提亮 肤色 精华液 保湿补水	保湿 补水 国产 干性	保湿补水 精华液
芦荟 胶晶 透温 变口 唇膏 持久 保湿 滋润 嘴唇 唇部 护理 彩妆 烂漫 紫红	持久 温变 中国大陆 保湿 滋润	持久 唇膏
豹纹 口红 丝绒 哑光 雾面 不沾杯 保湿 正红色 奶茶色 磁扣 方管 口红 枫叶丹	丝绒 红色	丝绒 口红
女士 护肤套装 礼盒 洗面奶 爽肤水 乳液面霜 补水 保湿 水润 提亮 滋润 紧致 金致 臻颜 奢养 洁面 面霜	国产 深层清洁 保湿 提拉紧致 补水 任何肤质	深层清洁 护肤套装
纷泽 靓丽 琉金 唇膏 润娇 唇色 滋养 保湿 唇蜜 丰润 双唇 口红 唇彩 琉金棕	滋养 中国大陆 保湿	滋养 口红
口红 沙色 口红 正红色 口红 礼盒 包装 唇膏 唇色 密码 柚色	润泽镜面 中国大陆 红色	润泽镜面 口红
姿媚堂 护肤品 化妆品 美容院 专柜 正品 补水 保湿 春夏 清洁 面部 乳液 姿媚堂 绿茶 舒缓 丝柔霜 保湿滋润	国产 保湿 滋润 补水 任何肤质	保湿滋润 乳液
红参 蜗牛 原液 套装 洗面奶 爽肤水 乳液 精华液 素颜霜 补水 保湿 滋养 水乳 红参 蜗牛 原液 保湿六件套 原液套装	滋养 国产 爽肤 精华液 保湿 任何肤质 补水	精华液 原液套装
杏仁 系列 补水 保湿 滋润 臻白 润肤霜 保湿补水	保湿 补水 国产 干性 中性 油性 混合性	保湿补水 润肤霜
暖春 小金条 口红 礼盒 方管 套盒 圆管 唇膏 香水 圣诞节 红色 8支一心 礼盒	欧美 哑光雾面 红色	哑光雾面 口红
专营店 推荐 天然 肌活 虾青素 精华 原液 传明 黄金 精华 六胜肽 青春定格 原液	提拉紧致 国产 任何肤质	提拉紧致 虾青素
深海 藻肌底 保湿 美颜 护肤品 套装 补水 保湿 滋润 紧致 肌肤 化妆品 组合 绿洲 洁面 保湿水 保湿乳 保湿霜 清润型 护肤品套装	国产 深层清洁 保湿 提拉紧致 补水 任何肤质	深层清洁 护肤品套装
情人节 阿玛尼//// 口红 礼盒 女友 生日 礼物 大礼盒	欧美	欧美 口红
配送 专柜 正品 魅可(mac) 经典 唇膏 子弹头 口红 显色 口红 唇膏 正红 玫红色	显色 红色	显色 口红
宝石 小白管 红管 滋润 口红 持久 掉色 不沾杯 平价 番茄 番茄 焦糖色	持久 不沾杯 滋润	不沾杯 口红
汤姆福特(tom 口红 唇膏 女友 老婆 礼物 生日 礼物 玫瑰 礼盒 香+ 魅+迪四 自选装	玫瑰	玫瑰 口红
专柜 正品 香水 女士 真我 花漾 甜心 小姐 漫舞 女士 香氛 香水 持久 香送 女友 情人 生日 礼物 花漾 甜心 淡香 赠礼 专柜 礼袋	送礼 职场 聚会 日常 花果香调 女士	花果香调 香氛
温度 果冻 口红 变色 唇膏 约会 粉红		口红
水柔 保湿 精乳 补水乳液 化妆品	国产 保湿 任何肤质	保湿 补水乳液
正品 绿叶 爱生活 护肤品 套装 希诺丝 化妆品 套装 花蜜 柔肤 水乳 精华 面霜 官方 旗舰店 旗舰 花蜜 套^_^下单 化妆品品套装	柔肤	柔肤 化妆品品套装
罗勒 橙花 香水 罗勒 橙花	女士 花香调 日常	花香调 香水
女士 乳液面霜 擦脸油 快速 吸收 长效 保湿 滋养 舒缓 脸部 全身 干燥 肌肤 经典 国货 sod蜜 4瓶装	进口 保湿 任何肤质	保湿 乳液面霜
三八 妇女节 礼物 禁忌 漆光 口红 唇膏 叛逆红 黑丝带 禁忌	自然 红色	自然 口红
芦荟胶 面膜 精华霜 面霜 补水 保湿 控油	控油 国产 保湿 任何肤质 补水	补水 面霜
情人节 礼物 口红 臻致 丝绒 哑光 唇釉 红管 限定 套装 女友 礼物 红管 橘红色 限定套装	欧美 哑光雾面 红色	哑光雾面 限定套装
赠品 小皙 护肤品 套装 洁面奶 面膜 洋甘菊面膜 2盒 备长 面膜 1盒 护肤品套装	洁面 任何肤质 洋甘菊 国产	洁面 护肤品套装
香港 直邮 花草 水语 葡萄柚 柑橘 绿茶 热带 青柠 娇嫩 玫瑰 女士 中性 淡香水 花草 水语 柑橘 罗勒 女士香水 精装	玫瑰 柑橘 女士 淡香	玫瑰 淡香水
赠品 套装 香水 体验 支装 赠品套装	约会 通用 花果香调	花果香调 赠品套装
专营店 水润 亮泽 液体 唇釉 饱满 防水 掉色 唇彩 口红 夏季	亮泽 水润 防水 液体	水润 唇釉
补水 保湿 精华 烟酰胺原液 保湿补水	保湿 补水 国产 任何肤质	保湿补水 烟酰胺原液
白皙 红润 祛斑霜 美白 晚霜 脸部 色斑 黑斑 淡化 化妆品 女士 祛斑 产品	国产 控油平衡 细致毛孔 抗氧化 任何肤质	控油平衡 晚霜
韩国 素颜霜 懒人霜 维他 面霜 嫩白 补水 保湿霜 多效 修护 滋养霜 裸妆 卸妆	干性 中性 油性 进口 补水	补水 面霜
都市 歌丽 姿美 容院 化妆品 净白 修复 女士 护肤品 专柜 保湿 活力水 乳细胞 活力 再生乳	修复 保湿 净白	净白 再生乳
胡萝卜素 口红 持久 脱色 补水 滋润 孕妇女 变色 润唇膏 学生 石榴红	持久 润唇 滋润 补水	持久 口红
口红 粉色 笔刷 彩妆 不易 掉色 不易沾杯 唇彩 液体 口红 哑光	中国大陆 红色	红色 口红
奥迪 橘色 干枯 玫瑰色 口红 口红 玫红色	欧美 哑光雾面 红色	哑光雾面 口红
套装 白色 纯白之恋 补水 保湿 提亮 肤色 击退 黯沉 洁面水 乳霜 化妆品 套装 保湿 滋润 白色 纯白露 淡斑保湿 化妆品套装	保湿 淡斑 美白 补水 国产 任何肤质	淡斑保湿 化妆品套装
紫玲珑 化妆品 套装 正品 紫玲珑 臻白 美颜 套装 保湿 护肤品 套装 化妆品套装	国产 保湿 任何肤质	保湿 化妆品套装
英国 伦敦 圈层 素颜霜 男士 素颜霜 男士 遮瑕霜 男士 bb霜 痘印 正品 保证 化妆品 套装 素颜霜 洗面奶 爽肤水 化妆品套装	国产 保湿 任何肤质	保湿 化妆品套装
美容院 白叁度 娃娃 防晒乳 水透白 防晒乳 白三度	防晒 任何肤质 国产	防晒 防晒乳
韩国 水光 唇釉 染唇液 唇蜜 雾面 哑光 持久 滋润 提升 气色 南瓜 茶色 缺氧	持久 雾面 韩国 哑光 滋润 提升气色	提升气色 唇釉
胡萝卜素 口红 学生 平价 小样 脱色 唇釉 小众 品牌 丁变色 唇膏 姨妈红		口红
臻彩 宝石 唇膏 新版 系列 口红 滋润 限量 正品 臻彩 宝石 唇膏 9支装 礼盒	滋润	滋润 口红
欧缇 尚洋 甘菊 护肤品 套装 保湿 补水 舒缓 过敏 提亮 肤色 孕妇 可用 洋甘菊皙 润舒 滋养 护水 护肤品套装	国产 补水 任何肤质	补水 护肤品套装
暖春 /粉色 绿色 邂逅 女士 香水套装 玫瑰 七夕 礼盒 生日 礼物 玫瑰 礼盒 香水 玫瑰 爱心	通用 花果香调 日常	花果香调 香水套装
暖春 柔和 净肤 系列 套装 小样 卸妆乳 卸妆水 洗面奶 柔和 水感 卸妆乳 系列套装	深层清洁 保湿 提拉紧致 国产 任何肤质	深层清洁 系列套装
活水 动力 补水 保湿 滋润 清爽 控油 细致 毛孔 爽肤水 柔肤乳液 护肤面霜 女士 护肤品 化妆品 柔肤水 乳液 精华液	所有肤质 国产 控油平衡 细致毛孔 保湿 补水	控油平衡 乳液
香港 地区 直发 圣罗兰 口红 迷魅 方管 唇膏 滋润 保湿 持久 脱色 哑光版 哑光	欧美 润泽镜面 红色	润泽镜面 口红
白雪公主 素颜霜 白霜 嫩白 遮瑕 妆前乳 隔离霜 懒人霜 100ml一 保湿补水	保湿 补水 进口 任何肤质	保湿补水 素颜霜
身体乳 全身 持久 保湿 滋润 香体 补水 单瓶 西柚 保湿滋润	国产 中性 保湿 滋润	保湿滋润 身体乳
毛孔 克星 樱萃 六胜肽 原液 提拉 抗皱 精华液 补水 正常 规格	补水 国产 任何肤质	补水 精华液
专柜 正品 口红 套装 礼盒 999金属 滋润 女士 唇膏 烈艳 蓝金 女生 闺蜜 生日 礼物 礼品 套装 滋润 表白 红】 专柜 礼盒 礼袋 口红套装	欧美 自然 红色	自然 口红套装
面霜 懒人霜 粉红 素颜霜 保湿 补水 提亮 肤色 遮瑕 专柜 学生 特价 保湿补水	保湿 补水 国产 任何肤质	保湿补水 面霜
琉璃 光彩 唇膏 口红 多色 亮丽 光泽 时间 保湿 琉光 蜜粉	光泽 中国大陆 保湿 多色	保湿 口红
口红 丝绒 哑光 牛血色 唇膏 持久 防水 抖音 番茄色	丝绒	丝绒 口红
意大利 双头 唇釉 唇彩	自然	自然 唇釉
特润 精华露 棕瓶 精华 小样 高能 精华 新品 高能 棕瓶 精华 1瓶	提亮肤色 保湿 抗皱 抗衰 进口 任何肤质	提亮肤色 精华露
独角兽 口红 李佳琦 莫兰迪 复古 正红 唇膏 平价 学生 正红色 蓝罐 护唇膜	红色	红色 口红
上海 雪花膏 套装 美容 套装 组合 雪花 眼霜 面霜乳霜 补水 保湿 上海 女人 珍珠夜 乳霜 雪花膏 雪花膏套装	国产 保湿 任何肤质	保湿 雪花膏套装
护肤品 套装 保湿 补水 细致 毛孔 控油 平衡 化妆品 盒装 沙棘 透亮 保湿 组合 敏感肌 可用 沙棘 精华乳 护肤品套装	控油平衡 保湿 舒缓镇静 补水 国产 任何肤质 干性 中性 油性	控油平衡 护肤品套装
新款 胶原蛋白 面霜 补水 保湿 滋润 温和 乳液 身体乳 男女 学生 保湿滋润	国产 保湿 滋润 补水 任何肤质	保湿滋润 乳液
古风 固体 香膏 女士 香膏 香水 学生 持久 清新 香水 淡雅 香膏 松柏	持久 女士 固体 情趣	持久 香水
墨菊 补水 凝脂 面霜 精华霜 滋润 保湿 滋润 护肤 保湿补水	保湿 补水 国产 任何肤质	保湿补水 面霜
品牌 授权 一正 小金瓶 活性肽 补水 修复 精华 原液 小分子 嫩肤乳 能量 保湿 提亮 淡纹 护肤品 修复 套装 小分子 肽能量 1瓶100ml 护肤品修复套装	国产 任何肤质 控油平衡 提亮肤色 补水	控油平衡 护肤品修复套装
墨菊 护肤品 套装 美肤 白嫩巨 补水 保湿 滋润 女霜 细致 毛孔 爽肤水 控油 祛痘洗面奶 水乳套装 礼盒 女士 学生 化妆品 4件套 洗面奶 乳+ 眼霜 化妆品4件套	国产 控油平衡 深层清洁 保湿 补水 任何肤质	控油平衡 化妆品4件套
乐肤洁 抗痘 控油 清爽 套装 洁面泡沫 洗面奶 爽肤液 水乳 抗痘 洁面泡沫 清爽套装	控油平衡 深层清洁 保湿 所有肤质	控油平衡 清爽套装
新款 小安瓶 丝蛋 白燕 精华液 补水 保湿 抗皱 紧致 原液 端兰 丝蛋 白燕 精华液 抗皱保湿	国产 保湿 抗皱 补水 任何肤质	抗皱保湿 精华液
亮采 系列 护肤品 组合 套装 美肤 补水 保湿 嫩白 细致 毛孔 化妆品 亮采 洗面霜 爽肤水 精华液 眼霜 日霜 晚霜 粉底 护肤品组合套装	爽肤 精华液 保湿 细致毛孔 补水	细致毛孔 护肤品组合套装
简装 精装 女士 淡香水 竹恋 试管	花果香调 女士	花果香调 淡香水
三八 妇女节 礼物 方管 限量 黑金 口红 橘色 礼盒 方管	橘色	橘色 口红
中年 妈妈 护肤品 套装 贵妇膏 神仙膏 胎盘膏 水乳霜 抗皱 淡化 皱纹 斑点 女士 化妆品 补水 保湿 套盒 黄金 蜗牛 原液 套盒 妈妈 礼品 护肤品套装	舒缓镇静 抗皱 提拉紧致 补水 国产 任何肤质	舒缓镇静 护肤品套装
三源 集萃 8杯 护肤套装 补水 保湿 化妆品 女士洗面奶 爽肤水 乳液 套装 美肌水 保湿乳 清润 保湿霜 保湿补水	保湿 补水 国产 任何肤质	保湿补水 护肤套装
口红 撞色 咬唇妆 口红 双色 立体 唇膏 珊瑚 色/黄色	润泽镜面 韩国 红色	润泽镜面 口红
化妆 护肤 面部 保养品 鲟鱼子 化妆品 套装 精华乳 1整 肌水 肌底液 护面霜 洁面膏 化妆品套装	国产 任何肤质 控油平衡 细致毛孔 保湿 提拉紧致	控油平衡 化妆品套装
克缇 克丽缇^娜 美容院 化妆品 洁容霜 蛋白霜 肌霜 护肤品 套盒 正品 理由 退换 购物 无忧 虚拟 并非 实物 修护保湿	国产 任何肤质 干性 中性 混合性 保湿 修护 补水	修护保湿 洁容霜
美白 护肤品 套装 烟酰胺 美白 祛斑 补水 保湿 洁面 水乳 学生 美白 补水 精华水 精华乳 洁面乳 护肤品套装	美白 洁面 保湿 祛斑 补水	美白 护肤品套装
引力 果漾 挚吻 女士香水 偷吻 挚吻 绿色 优雅 百合 女香	休闲 日常 通用 花果香调	花果香调 女士香水
唇膏 口红 黑管 铆钉 口红 唇膏	欧美 润泽镜面 红色	润泽镜面 口红
芝蔓 美容院 专柜 化妆品 雪颜 精华液	国产 补水 任何肤质	补水 精华液
烈艳 烈焰 蓝金 唇膏 口红 女士 哑光经 典传 奇正 红色 圣诞节 限定 限量版 口红 套装 礼物 洋红色 口红套装	欧美 丝绒 红色	丝绒 口红套装
天才 黄油 补水 保湿 清爽型 啫喱 润肤乳液 18年 新款 透明 黄油	进口 控油平衡 任何肤质	控油平衡 啫喱
海洋之谜 净豆 精华液	国产 任何肤质 抗痘	抗痘 精华液
苗御堂 化妆品 实体 美容院 专柜 补水 修护 套盒 颜凝水 精华液	补水 国产 任何肤质	补水 精华液
自然 透白 套装 美白 补水 保湿 清洁 收缩 毛孔 淡化 斑点 正品 护肤品 礼盒 套装 官方 旗舰 官网 套餐 洁面 乳+ 素颜霜 淡斑保湿 护肤品礼盒套装	淡斑 保湿 美白 补水 国产 任何肤质	淡斑保湿 护肤品礼盒套装
冰雪 丽人 五件套 美白 套装 冰雪 丽人 美白 祛斑霜 套装 单品 洁面乳 无盒装 祛斑霜套装	祛斑 美白 洁面	美白 祛斑霜套装
官方 哑光口红 持久 保湿 不易 脱色 学生 豆沙色 唇膏 平价 小众国货 自由 搭配 专用 备注	持久 豆沙色 哑光 保湿	哑光 唇膏
羊胎素 玻尿酸原液 收缩 毛孔 提拉 淡化 细纹 抬头 纹法 令纹鱼 尾纹 精华液 2瓶装 折装 抗皱保湿	国产 任何肤质 细致毛孔 保湿 抗皱 提拉紧致	抗皱保湿 精华液
安平 玻尿酸 小安瓶 原液 补水 保湿 收缩 毛孔 护肤 面部精华 原液 7支 正常 规格	国产 补水 任何肤质	补水 面部精华
日本 古屋 珍珠 素颜霜 版极光 素颜霜	提亮肤色 进口 任何肤质	提亮肤色 素颜霜
固体 古龙 口袋 香水 持久 香膏 女士 学生 小众 香调 旅行装 便携 小样 随身 小样 古龙 香体膏 香氛 西瓜 红^无面者 攀登者	通用 聚会 休闲 约会 日常 花果香调	花果香调 香水
胡萝卜素 弹滑 粘杯 口红 持久 掉色 胡萝卜橙 烈焰 红/ 玫红 烈焰红	持久	持久 口红
花漾 溢彩 口红笔 防水 不沾杯 持久 保湿 滋润 不易 脱色 唇彩 持久 湿润 保湿 脱色 显色 持久 礼物 女友 学生 正品 9南瓜色/1.7g	持久 不沾杯 显色 保湿 防水 滋润	不沾杯 唇彩
护肤品 马油 香水 身体乳	国产 任何肤质 修护	修护 香水
鲜芦荟 补水 保湿 修护 润肤 套装 保湿 补水 滋养 肌肤 化妆品 套装 面部 护肤 滋润 护肤 营养 肌肤 男士 控油 保湿3件套 化妆品套装	国产 控油平衡 深层清洁 保湿 补水 任何肤质	控油平衡 化妆品套装
旗舰 专柜 套装 清透 调理水 平衡乳 面膜 洁面乳 补水 保湿 清爽 控油 收缩 毛孔 滋润 提亮 肤色 男女 组合 洁面 保湿补水 专柜套装	油性 混合性 保湿 补水 国产	保湿补水 专柜套装
面部精华 珍珠 光采 精华水 保湿补水	进口 任何肤质 细致毛孔 保湿 提拉紧致 补水	保湿补水 面部精华
德国 黑管 口红 不易 掉色 保湿 滋润 哑光 丝绒 孕妇 唇膏 玫红色	欧美 丝绒	丝绒 口红
正品 保障 海囤 全球 哑光口红 雾面 哑光 唇釉 液体 口红 玛莎 云朵 唇釉 鲜亮 红色	裸色豆沙色 韩国 自然	自然 唇釉
购2 口红 掉色 不沾杯 口红 正品 持久 保湿 掉色 不沾杯 礼盒 学生 哑光 闪光 套装 网红 小样 唇釉 经典 闪光套装	持久 不沾杯 闪光 保湿 哑光	不沾杯 闪光套装
精油 口红 唇膏 国货 裸色 颜值 口红 保湿 滋润 学者 色号 菱草色	滋润 保湿 裸色	保湿 口红
京东 礼遇 魔法医生 水乳套装 氨基酸 洁面 茉莉 水盈 嫩肌 弹力 保湿 保湿补水	保湿 补水 国产 中性	保湿补水 水乳套装
绿茶 清香 组合 修护 护肤套 温和 补水 补水 润肤 套控油 套装 夏季 绿茶 清香 爽肤水 冰露 套控油套装	国产 任何肤质 控油平衡 舒缓镇静 补水	控油平衡 套控油套装
蜗牛 原液 补水 护肤品 美容院 面部 护理 套装 洗面奶 爽肤水 乳液 面霜 眼精华 bb霜 蜗牛 水光 保湿补水 护理套装	保湿 提拉紧致 补水 国产 任何肤质	保湿补水 护理套装
韩国 口红 烟管 口红 哑光 丝绒 雾面 柔顺 滋润 显色 红棕色 红色	哑光雾面 裸色豆沙色 韩国	哑光雾面 口红
奈佰 中国 风故 口红 保湿 滋润 防水 不易 脱色 唇膏 套装 礼盒 情人 圣诞节 礼物 1支 小辣椒 唇膏套装	中国大陆 红色	红色 唇膏套装
妇女节 礼物 法国 欧丹 玛丽 蜗牛 润泽 滋养 口红 持久 保湿 不易 脱色 唇膏 透明 白色 气质	滋养 持久 透明 白色 保湿 润泽	润泽 口红
1茵 佳音 益生菌 女性 私处 私密护理 搭配 私处 保养 紧致 凝胶 1盒 2盒	紧致 中国大陆 保养	保养 凝胶
经典 大红 色口 红盘 功能 口红 腮红 唇蜜 6^色口 红盘	中国大陆 红色	红色 口红
莱法耶 馥绿德雅 滋养 精华素	滋养 任何肤质 进口	滋养 精华素
嫩白 套装 美白 淡班 黄补水 保湿 提亮 肤色 水乳 护肤品 化妆品 套装 学生 套餐 柔肤水 乳液 眼霜 化妆品套装	深层清洁 保湿 补水 国产 任何肤质	深层清洁 化妆品套装
口红 持久 保湿 防水 复古 姨妈 南瓜 豆沙色 唇膏 学生 可爱 红色	持久 豆沙色 保湿 韩国 红色 防水	持久 口红
鲜嫩 叶子 护肤品 叶子 套装 精华 洗面奶 保湿 滋润 收缩 毛孔 补水 护肤 洁面 乳液 保湿补水 护肤品叶子套装	保湿 补水 国产 任何肤质	保湿补水 护肤品叶子套装
白里 透红 化妆品 组合 精华素	国产 补水 干性 中性 油性 混合性	补水 精华素
支持 付款 深海 藻肌底 系列 补水 亮肤 滋润 保湿 洁面乳 洗面奶	任何肤质 干性 中性 油性 混合性 国产 细致毛孔 深层清洁 保湿 提拉紧致 补水	深层清洁 洗面奶
韩国 尹姬 弹滑 水面部 护理 套装 组合 弹滑 洁面乳 柔肤露 醒肤乳液 补水霜 护理套装	洁面 柔肤 进口 任何肤质 补水	洁面 护理套装
女士 淡香水 清新 绿茶 玫瑰 栀子 自然 桂花 熏衣草 学生 味^单 栀子花 礼包	女士 送礼 花香调	花香调 淡香水
小金条 口红 哑光 雾面 唇膏 呛口辣椒	雾面 哑光	哑光 口红
明星级 玻尿酸原液 保湿 补水 滋润 精华液 玻尿酸原液 2盒6支装 保湿补水	保湿 补水 国产 任何肤质	保湿补水 精华液
护肤 精华 洁面 水乳霜 玻尿酸原液 氨基酸 清透 洁净 洁面乳	洁面 任何肤质 国产	洁面 水乳霜
双旦 礼物 抗皱 精华液 肽抗 皱提 紧致 原液 淡化 面部 精华液 抬头法 令纹 2送 一同	提拉紧致 国产 任何肤质	提拉紧致 精华液
小铺 滋润 保湿 唇膏 不易 脱色 不易沾杯 防水 鱼姬 口红 紫红色 滋润	保湿 防水 滋润 红色	滋润 口红
镜面 唇釉 口红 持久 保湿 脱色 防水 染唇液 学生 爱07 7^咬我色 平替	持久 国产 保湿 防水 任何肤质 镜面	镜面 口红
官方 植物 果实 精华 护肤品 补水 面部 精华液 护肤油 保湿 滋润 滋养 修复 皮肤 屏障 乳木果 修护 精华	国产 任何肤质 干性 中性 油性 控油平衡 细致毛孔 保湿 补水	控油平衡 精华液
青春 女士 清新 花果 淡香 持久 女友 香水 粉色 柠檬 草莓 小菊 花香 水果 香味 香水 浅绿	花果香调 女士 日常	花果香调 香水
蔷薇 透亮 保湿 素颜霜 裸妆 遮瑕 提亮 打底 隔离 懒人 面霜 贵妇膏 美肌 白皙 女士 蔷薇 透亮 保湿 素颜霜	国产 任何肤质 提亮肤色 保湿 滋润 补水	提亮肤色 面霜
美白 祛斑霜 精庄 金依析 祁白 红套装 一代 正品 早晚 化妆品 护肤品 专柜 正品 洗面奶 保湿补水 套装	保湿 补水 国产 任何肤质	保湿补水 套装
旧迷楼 二十四 节气 系列 古风 香水 持久 淡香 清新 女士 迷楼 山寺 香水 固体香水 香氛 女用 古刹白 莲花 菩提 清明 以下	持久 固体 淡香	持久 香水
持久 脱色 丝绒 哑光 唇釉 6克 午夜 摩卡	欧美 哑光雾面	哑光雾面 唇釉
女士香水 持久 清新 淡香水 邂逅 真我 可可 5号 香氛 花漾 香氛 学生 少女 清新 生日 礼物 070礼拜五	女士 花香调 日常	花香调 香氛
化妆品 蜜施 华保 柔肤露 滋润 面霜 乳液 补水 保湿霜	国产 干性 中性 提亮肤色 保湿 补水	提亮肤色 乳液
套装 金致 臻颜 奢养 紧妍 护肤品 套装 精华 水乳液 眼霜 皱提 洁面乳 精华水 乳液 日霜 保湿补水 护肤品套装	保湿 补水 国产 任何肤质	保湿补水 护肤品套装
丝绒 丰润口 持久 不沾杯 不易 掉色 防水 润唇膏 植物 萃取 口红 正品 正红色	丝绒 裸色豆沙色 中国大陆	丝绒 口红
欧贝诗 极美 娇颜 系列 化妆品 专柜 护肤品 套盒 欧贝 诗凝 活颜 焦点 眼霜 保湿滋润	国产 保湿 滋润 补水 任何肤质	保湿滋润 眼霜
元气 少女 炫彩 丝绒 珍珠 悦色 珠润 口红 焦糖 布蕾	丝绒	丝绒 口红
汽车 风口香水 海洋 古龙 魅动 香熏 精油 去除 异味 魅动	运动 通用 花果香调	花果香调 精油
玻尿酸 靓颜 牛奶 蛋白霜 保持 遮瑕 提亮 肤色 玻尿酸 靓颜 牛奶 蛋白霜	国产 任何肤质 提亮肤色 保湿 补水	提亮肤色 玻尿酸
事后 清晨 白兔 大吉岭茶 风铃 小确幸 少女 淡香水 学生 持久 清新 维蜜 甜心 香水	花果香调 女士 日常	花果香调 香水
魅可(m.a.c) 口红 子弹头 新色 磨砂 唇膏	欧美 哑光雾面 红色	哑光雾面 口红
汤姆.福特 黑管 口红 黑管 白管 口红 显色 滋润 气色 白细管	欧美 橘色 润泽镜面	润泽镜面 口红
口红 烈焰 幻魅 唇膏 贺卡 3支装 礼盒 色号 留言 备注 新款 除外	欧美 润泽镜面	润泽镜面 口红
经典 基础 3号 系列 化妆品 组合 套装 补水 保湿 细致 毛孔 嫩白 肌肤 提亮 肤色 包邮 3号 油性 爽肤水 洁面泡沫 润肤 凝露 面膜霜 化妆品组合套装	提亮 洁面 爽肤 保湿 细致毛孔 泡沫 补水	细致毛孔 化妆品组合套装
柔色 魅惑 口红笔 水润 娇唇 唇彩 滋润 保湿 不易 脱色 化妆品 绯红色	保湿 水润 滋润 红色	水润 唇彩
小城伊香 品牌 黑鸦片 咖啡 女士香水 学生 少女 清新 自然 持久 淡香水 风铃	女士 花香调 日常	花香调 女士香水
香水 熏衣草 香茉莉 玫瑰 桂花 百合 香味 学生 魅力 吸引 香水 茉莉	通用 花香调 日常	花香调 香水
脸颊 太阳穴 额头 饱满 法令 纹丰 卧蚕 精油 眼窝 泪沟 凹陷 填充 苹果 下巴 丰盈 脸部 丰盈 面部 精华液	丰盈 精华液	精华液 精油
孩儿面 面霜 黄瓜 水凝露 面霜 宝宝润肤乳 锁水 保湿 儿童面霜 粉色 牛奶 营养霜 保湿滋润	国产 保湿 滋润 补水 任何肤质	保湿滋润 面霜
口红色粉 口红 材料 口红粉 原料 红梅	中国大陆 红色	红色 口红
贵妇膏 美嫩白 斑淡化 痘印 素颜霜 补水 遮瑕 懒人 保湿 素斑 提亮 肤色 正品 珍珠 胎盘 神仙膏 面霜 男女 贵妇膏	国产 控油平衡 保湿 美白 补水 任何肤质	控油平衡 面霜
肌源 水弹 系列 保湿型 修护 精华露 眼霜 护肤 化妆品 肌源 水弹 保湿 清润乳 全新 上市	任何肤质 修护 保湿 进口	保湿 眼霜
化妆品 胶原 柔肤乳液 补水 保湿 提拉 紧致 提亮 肤色 护肤品 官方 旗舰 保湿滋润	保湿 滋润 修护 补水 国产 任何肤质	保湿滋润 柔肤乳液
女生 小众 祖马龙 味道 香水小样 套装 礼盒 正品 蓝风铃鼠 尾草 海盐 小瓶 香水 女士 持久 淡香 清新 祖马龙 香橙花 正装 香水小样套装	女士 送礼 休闲 日常 花香调	花香调 香水小样套装
专柜 正品 唇釉 番茄 红管 丝绒 黑管 唇釉 表白 女友 情人 礼物 红管 樱桃 红色 专柜 礼盒	欧美 丝绒 红色	丝绒 唇釉
金流 沙蓝 风铃 奶香 女士 清新 香水 学生 持久 淡香 私处 香水 异味 诱惑 柏林 少女 柏林 少女	持久 淡香 通用 职场 休闲 日常	持久 香水
水漾 护肤品 套装 化妆品 洗面奶 水乳 正品 官方 旗舰店 肌初 美容液 红瓶 中样 清爽型 抗皱补水 护肤品套装	所有肤质 国产 抗皱 提拉紧致 晒后修复 补水	抗皱补水 护肤品套装
绿叶 爱生活 玻尿酸 水活 原液 增强 肌肤 弹性 深层 补水 防御 修复	修复 弹性 补水	弹性 玻尿酸
医采 护肤品 水光 护肤 套盒 补水 套装 化妆品 补水 护肤品 套装 补水 保湿 滋养 润肤 蓝色 肌活 净透 保湿 洁面乳 保湿补水 护肤品套装	保湿 补水 国产 干性 中性 油性 混合性	保湿补水 护肤品套装
三八 妇女节 礼物 烈焰 蓝金 限定 礼盒 情人 新年 限量 红管 口红 套装 生日 礼物 红管 口红套装		口红套装
雪润 皙白 套装 美淡 白斑 保湿 补水 提亮 肤色 护肤品 化妆品 套装 官方 旗舰 正品 洁面 乳+ 眼霜 淡斑保湿 化妆品套装	保湿 淡斑 美白 补水 国产 任何肤质	淡斑保湿 化妆品套装
诗芒 香水 女士 持久 留香 淡香 清新 香氛 自然 私处 香水 异味 诱惑 流沙 冥府 流沙蓝 风铃	持久 淡香 自然 通用 职场 休闲 日常	持久 香水
果之秘 孕妇 植物 坚果 护肤品 套装 提亮 补水 保湿 美肤 锁水 控油 男女 学生 化妆品 套装 6件 水+ 乳液 洁面 精华 保湿补水 护肤品套装	保湿 补水 国产 任何肤质	保湿补水 护肤品套装
旗舰 植物 水感 控油 保湿 补水 凝肌乳 保湿滋润	国产 保湿 滋润 补水 任何肤质	保湿滋润 凝肌乳
绝色 持久 魔方 唇膏 滋润 哑光 丝绒 口红 不易 掉色 彩妆 姜饼 红茶 缎面 光泽	持久 丝绒 中国大陆 哑光 光泽 滋润	持久 口红
复颜 光学 嫩肤 抚痕 乳液 抚平 细纹 紧实 肌肤 深入 修护 保湿滋润	进口 干性 保湿 滋润 补水	保湿滋润 乳液
维娜 韩国 化妆品 美容院 专柜 丝慧 依艾丽 白雪 乳液 保湿补水	保湿 补水 国产 任何肤质 干性 中性 混合性	保湿补水 乳液
蜗牛 舒润 保湿 补水 莹润 面部 护肤品 洁面乳 爽肤水 乳液 眼霜 面霜 bb霜 单品 组合 礼盒 套装 规格 套礼 盒装 保湿补水 礼盒套装	国产 任何肤质 细致毛孔 保湿 提拉紧致 补水	保湿补水 礼盒套装
清润 葡萄籽 护肤 化妆品 套装 洗面奶 女士 补水乳 保湿 提亮 肤色 膜力 乳液 膜力 保湿补水 化妆品套装	保湿 补水 国产 任何肤质	保湿补水 化妆品套装
口红 女士 唇膏唇彩 掉色 不沾杯 持久 保湿 防水 雾感 哑光 滋润 口红 纯色 唇膏 复古 酒红	哑光雾面 中国大陆 红色	哑光雾面 口红
韩国 黄金 浓缩 精华 玻尿酸 肌底液 精华 原液 精华 原液 保湿补水	保湿 补水 进口 任何肤质	保湿补水 肌底液
面部 护理 套装 学生 黄金 玻尿酸 臻颜 润肤 网红 肽修 面膜 保湿补水 护理套装	保湿 补水 国产 中性	保湿补水 护理套装
礼盒 套装 保湿 滋润 护肤 韩国 原装 进口^天率 丹和率 礼盒 6件套328ml 保湿补水 礼盒套装	保湿 补水 进口 中性	保湿补水 礼盒套装
男士香水 持久 淡香 清新 自然 男人 男女 可用 香氛 费洛蒙 古龙水 蔚蓝 男士 运动 香水 蓝瓶	东方香调 男士 送礼 职场 户外 约会	东方香调 香水
精华液 小白 水感 白光 精华露 领取 优惠券 减5 小白瓶 保湿补水	混合性 保湿 补水 国产	保湿补水 精华液
男士 素颜霜 懒人 面霜 bb霜 美肤 白皙 遮瑕 黑眼圈 痘印 隔离 粉底液 修颜 提亮 肤色 男生 学者 护肤 化妆品 套装 懒人 美肤 洗面奶 素颜霜 化妆品套装	提亮肤色 国产 任何肤质	提亮肤色 化妆品套装
黑鸦片 黑色 飘茗 蓝鸦片 女士香水 保税 发货 蓝色 鸦片 19年 新款	送礼 休闲 约会 日常 清新香调 女士	清新香调 女士香水
特价 女王 宝石 镜面 口红 钻石 壳子 年红 口红 含壳	镜面	镜面 口红
套装 礼盒 女士 护肤品 紫熨斗 眼霜 复颜 玻尿酸 护肤 化妆品 套装 补水 保湿 膨膨水 乳液 化妆品套装	保湿 补水	补水 化妆品套装
妍美 容院 专柜 化妆品 女士 护肤品 净化 舒缓 面贴膜 5片	任何肤质 舒缓 国产	舒缓 面贴膜
奢养 肌活 青春液 精华液 青春 乳能量 洗面奶 面膜 护肤品 青春液 1瓶150ml	任何肤质 精华液 进口	任何肤质 精华液
植物 芽萃 水嫩 清新 保湿 补水 护肤品 套装 水乳 植物 嫩肤 植物 芽萃 爽肤水 植物 芽萃 保湿乳 护肤品套装	国产 补水 任何肤质	补水 护肤品套装
油痘 肌^清痘 控油 补水 水乳套装 控油乳液 面部 护理 护肤品 痘肌 爽肤水 乳液	国产 控油平衡 保湿 抗痘 补水 任何肤质 油性 混合性	控油平衡 水乳套装
女士 雪颜 粉嫩 透白 乳液面霜 补水 保湿 系列 复颜 抗皱 洗面奶 保湿美白	进口 保湿 美白 修护 补水 任何肤质	保湿美白 洗面奶
情人节 女友 香膏 香氛 固体香水 小雏菊 清新 香体乳 淡香水 男士 魅惑 许愿精灵	固体 香体 通用 淡香	香体 香膏
春季 尚新】 苏卡娜 魅惑 炫彩 口红 保湿 滋润 不易 掉色 脱色 口红 唇膏 姨妈色	滋润 保湿	保湿 口红
美白 套装 新七 系列 美白 提亮 肤色 补水 保湿 洗面奶 精华水 水乳 护肤品 淡化 细致 毛孔 提拉 官方 化妆品 新七 美白 晚霜 美白套装	国产 控油平衡 淡斑 美白 任何肤质	控油平衡 美白套装
专营店 薇风 第四 大水 精华 凝乳 面膜 保湿 分子 玻尿酸 熬夜 修护 黑膜 2盒20 保湿补水	保湿 补水 进口 任何肤质	保湿补水 面膜
新品 领券 魅惑 润唇蜜 变色 唇膏 黑管 系列 滋润 保湿 变色 唇膏 橘色	欧美 橘色	橘色 唇膏
口红 琉晶 秀色 柔润 温变 保湿 滋润 口红 俏玫红	温变 滋润 保湿	保湿 口红
曼瑜 天雅 童颜 喷雾 官网 新款 曼瑜 童颜 喷雾 精华 套装 防修 护衰 滋润 皱纹 提拉面部 护肤^曼瑜 喷雾 精华套装	国产 修护 喷雾 任何肤质 滋润	修护 精华套装
黄金 蜗牛 原液 护肤品 套装 美白 抗皱 紧致 补水 保湿 洗面奶 淡化 斑点 黑色素 美白霜 中年 妈妈 化妆品 补水套装 护肤品套装	国产 任何肤质 控油平衡 深层清洁 抗皱 补水	控油平衡 护肤品套装
杜鲁 楚萨迪 嫣香 天之骄女 根缘 蔚蓝 大地 男士香水 女士香水 嫣香 女士 根缘 大地 男士 淡香水	女士 花香调 送礼 职场 约会 日常	花香调 女士香水
玻尿酸 保湿 精华 化妆品 套装 保湿 补水 护肤品 洁面乳 嫩肤水 眼霜 精华乳 bb霜 洁面乳 嫩肤水 精华乳 眼霜 化妆品套装	国产 补水 任何肤质	补水 化妆品套装
迷魅 方管 唇膏 口红 滋润 保湿 持久 掉色 情人节 礼物	保湿 欧美 持久 滋润	滋润 口红
宝丽 系列 敏感 肌肤 调理 化妆水	进口 补水 任何肤质	补水 化妆水
羊皮口 红红丝绒 口红 婚纱 礼盒 老婆 朋友 生日 礼物 三八 女神 礼物 羊皮 复古 大红	欧美 丝绒	丝绒 口红
韩国 直邮 中样 套装 小样 试用 水乳霜 旅行 套盒 孕妇 可用 黑色 氧气 泡泡面膜 6片 清爽 中样套装	进口 淡斑 晒后修复 任何肤质	淡斑 中样套装
哑光口红 唇膏 女士 不易 掉色 保湿 滋润 防水 不易沾杯 包邮 转红色	中国大陆 红色	红色 唇膏
临期 清仓5 日本 洗面奶 水乳 爽肤水 乳液 卸妆乳 面霜 植物 韵律 卸妆乳 保湿美白	保湿 美白 提拉紧致 进口 任何肤质	保湿美白 乳液
素颜霜 遮瑕 滋润 懒人霜 补水 保湿 提亮面霜 遮瑕膏 遮斑 粉底液 素颜霜 雀斑 修容 高光 学生	国产 任何肤质 提亮肤色 保湿 滋润 补水	提亮肤色 素颜霜
圣诞 礼物 女友 花草 水语 无花果 鸢尾 女士香水 淡香水	花果香调 女士	花果香调 女士香水
如新 化妆品 凝霜 克春 夏保湿 补水 滋润 素颜 脸霜 护肤品 凝霜	国产 保湿 干性 中性 油性 混合性	保湿 脸霜
官方 旗舰 祛痘膏 祛印 修护霜 护肤品 套装 男女 护肤品 臻品 套盒 护肤品套装	祛痘 国产 任何肤质	祛痘 护肤品套装
暖春 顺丰 方管 口红 圆管 唇釉 方管 珊瑚色	欧美 润泽镜面 红色	润泽镜面 口红
优雅 润亮 霜套 熊津 韩国 熊津 化妆品 瑞丝 优雅 润亮 霜套 套装 精华 套润 润亮 乳润亮 霜润 精华 润亮 精华 保湿补水 霜套套装	保湿 补水 国产 任何肤质	保湿补水 霜套套装
澳洲 进口 卢卡斯 滋润 保湿 万用膏 润唇膏 男女 婴儿 湿疹	保湿 润唇 滋润 进口	滋润 润唇膏
情人节 礼物 口红 方管 圆管 礼盒 小金条 唇釉 朋友 生日 礼物 方管 口红 正红色	红色	红色 口红
情人 节纪 梵希 限量 小羊皮 口红 礼盒 造物 礼物 姨妈 珊瑚 色红 女友 生日 礼物 禁忌 一生一世 音乐 礼盒	欧美	欧美 口红
禁忌 霓虹 唇膏 水墨 大理 石纹 黑丝带 口红 唇膏 亮粉 清仓 特价	欧美 润泽镜面	润泽镜面 唇膏
巴宝莉 女士 淡香水 红粉 恋歌	运动 约会 日常 花果香调 女士	花果香调 淡香水
慕色 奢美 口红 唇膏 滋润 丝绒 经典 红管 化妆品 彩妆 学生 女平价 姨妈色	滋润 丝绒	滋润 口红
护肤品 礼盒 氨基酸洗面奶 面部 黄祛斑 美白 淡斑 补水 保湿套装 女士 化妆品 套装 收缩 毛孔 雪肌 无暇 润白 精华液 抗皱淡斑 化妆品套装	国产 淡斑 抗皱 美白 任何肤质 干性 中性 混合性	抗皱淡斑 化妆品套装
春季 新品 口红 学生 平价 小众 品牌 哑光 丝绒 保湿 小金条 璀璨 宝石 奶油 质地	丝绒	丝绒 口红
镜面 唇釉 唇蜜 唇彩 口红 小众平价 蜜桃 番茄色	镜面 中国大陆	镜面 唇釉
粉黄黑 水晶 女士 淡香水 晶钻 粉钻 香恋 水晶	清新香调 送礼 聚会 约会 女士	清新香调 淡香水
口红 学生 豆沙色 雾面 哑光 掉色 防水 口红 套装 组合 礼盒 口红套装	中国大陆 自然 红色	自然 口红套装
幻时 系列 化妆品 补水 保湿 皱提 紧致 细致 毛孔 清洁 肌肤 提亮 肤色 护肤品 包邮 玫琳 凯幻 黑眼圈 修护 精华露 抗皱保湿	国产 保湿 抗皱 提拉紧致 补水 任何肤质 干性 中性 油性	抗皱保湿 精华露
正品 保障 小样 试用 装袋 旅行 套装 整包 逆时空 山茶花 奇迹水 水乳 小样 时空 精华 补水美白 旅行套装	所有肤质 美白 补水 防晒隔离 进口	补水美白 旅行套装
固体香水 女士 淡香 持久 男士 香膏 古风 学生 自然 香膏 中国风 情劫 适合 女生	送礼 聚会 日常 通用 花香调	花香调 香膏
情人节 礼物 口红 套装 8支 圣诞 限量 礼盒 小辣椒 魅可 豆沙色 表白 礼物 生日 朋友 生日 新品 大气 一朵独秀 夜光花 2支 口红套装	豆沙色	豆沙色 口红套装
口红 炫亮 魅力 唇膏 不沾杯 豆沙红 胭脂	丝绒	丝绒 口红
国内 专柜 口红 女士 唇釉 丝绒 哑光秋 陶土 系列 红棕 陶土 红棕 磨砂 限量 玫瑰花 礼盒	欧美 哑光雾面 红色	哑光雾面 唇釉
无暇 素颜霜 素颜 瓷亮 水润 滋养 饰容 透亮 渗透 滋养 持妆 服帖 亮采 无暇 素颜霜	滋养 水润 国产 服帖 任何肤质	水润 素颜霜
护肤品 套装 补水 保湿套装 立体 透白 滋润 保湿 面部 水乳霜 护肤品 水乳霜 精华 眼霜 水光 透亮 遮瑕 bb霜 象牙白 护肤品套装	国产 提亮肤色 细致毛孔 保湿 补水 任何肤质	提亮肤色 护肤品套装
热门 色号 魅可 子弹头 时尚 唇膏 3克	欧美 哑光雾面 红色	哑光雾面 唇膏
玻尿酸 补水 原液 面部 补水 保湿 柔嫩 光滑 男女 高效 保湿 精华 护肤 原液 玻尿酸 补水 原液 赠品	控油平衡 保湿 提拉紧致 补水 国产 任何肤质 干性 中性 油性	控油平衡 玻尿酸
青春 系列 香水 小时光 幸运 小梦 美好 学生 男孩 女孩 文具 礼物 故事 香水	通用 花果香调 送礼	花果香调 香水
收缩 毛孔 精华液 告别 粗大 毛孔 迎接 水嫩 皮肤 精华液 升级版	国产 控油平衡 细致毛孔 保湿 补水 任何肤质	控油平衡 精华液
晶灵 洁面 乳液面霜 精华 系列 雪晶 灵^焕亮 细致 轻盈霜 保湿滋润	保湿 滋润 抗皱 补水 进口 任何肤质	保湿滋润 乳液面霜
圣诞 礼物 女友 七夕 情人节 礼物 口红 套装 方管 圆管 限量 烟花 礼盒 套盒 其它 颜色 我爱你 口红套装	泰国	泰国 口红套装
冻乳 补水 保湿乳液 清爽 护肤 精华 小颗粒 滋润 补水滋润	进口 保湿 滋润 补水 油性	补水滋润 保湿乳液
三八 妇女节 礼物 口红 南瓜 枫叶红 姨妈 番茄 套装 礼盒 朋友 生日 礼物 白管 热门 西柚 精美 礼盒 番茄套装		番茄套装
2支 果冻 变色 口红 持久 保湿 防水 学生 滋润 唇膏 套装 无色 润唇膏 变色 变色 淡粉 淡紫 唇膏套装	持久 保湿 防水 润唇 滋润	持久 唇膏套装
澳洲 水光针 涂抹式 玻尿酸 精华液 保湿 补水 提亮 肤色 蜂毒 面膜 8杯 抗皱淡斑	进口 任何肤质 淡斑 抗皱 美白 抗衰	抗皱淡斑 面膜
佰莲凯 美容院 化妆品 专柜 阳光 轻透 莹润 粉底液	任何肤质 进口	任何肤质 粉底液
品琪 化妆品 美容院 修护 补水 套盒 正品 丝柔 隔离 修颜乳	国产 舒缓镇静 修护 补水 任何肤质 干性 中性 混合性	舒缓镇静 修颜乳
巧克力 护肤品 套装 补水 紧致 水乳 化妆品 专柜 品牌 正品 丝滑 丝滑乳 护肤品套装	国产 任何肤质 控油平衡 细致毛孔 提拉紧致 补水	控油平衡 护肤品套装
套装 花颜 凝时 套盒 茶花 水乳套装 女士 护肤礼盒 提拉 补水 保湿 乳液 精华 洗面奶	进口 补水 任何肤质	补水 水乳套装
丝滑 滋润 口红 哑光易 上色 持久 保湿 晕染 厂家 直销 学生 网红款秋 冬季 热卖 口红 豆沙色	哑光雾面 裸色豆沙色 中国大陆	哑光雾面 口红
敏感 安心 润肤 护肤品 系列 水乳套装 干燥性 敏感肌 润肤水 保湿 化妆品 保湿补水	保湿 舒缓镇静 补水 国产 任何肤质	保湿补水 水乳套装
女士香水 独角兽 天马 女士 淡香水	职场 聚会 休闲 约会 花果香调 女士	花果香调 女士香水
香港 直邮 日本 尊马油 北海道 保湿 马油 润肤面霜 孕妇 可用 尊马油 尊马油 1瓶	控油平衡 保湿 抗痘 进口 任何肤质	控油平衡 润肤面霜
懒人 美白 素颜霜 裸妆 遮瑕 隔离 滋润 保湿 补水 乳液面霜 提亮 肤色 女士 正常 规格	进口 补水 任何肤质	补水 素颜霜
护肤品 组合 套装 深海 凝萃 补水 保湿 清爽 润泽 滋养 肌肤 便携 保湿水 70ml两 护肤品组合套装	国产 控油平衡 细致毛孔 保湿 补水 任何肤质	控油平衡 护肤品组合套装
古驰 花之舞 花园 晚香玉 栀子花 女士 淡香水 自然 清新 柑橘	送礼 情趣 聚会 日常 通用 花香调	花香调 淡香水
高级 定制 小羊皮 香榭 天鹅 唇膏 橘红色	欧美 哑光雾面	哑光雾面 唇膏
专柜 行货 红颜萃 抗皱 紧致 护肤品 套装 补水 保湿 化妆品 补水 保湿 紧致 提拉提亮 肤色 洁面 面霜 护肤品套装	控油平衡 保湿 提拉紧致 补水 混合性 国产	控油平衡 护肤品套装
精选 玻尿酸原液 护肤品 套装 化妆品 礼盒 正品 学生 适用 紧致水 乳液面霜 修护 补水 保湿 孕妇 可用 玻尿酸 保湿补水 护肤品套装	保湿 补水 国产 任何肤质	保湿补水 护肤品套装
医院 同款 绽研妍 水乳 皮肤 敷料 绽颜 补水 保湿 护肤品 套装 绽妍 面膜 5片 护肤品套装	国产 补水 任何肤质	补水 护肤品套装
保证 正品 蜗牛 原液 精华 爽肤水 乳液面霜 洗面奶 补水 保湿 滋润 收缩 毛孔 护脸霜 擦脸油 油祛痘 洁面乳 化妆 爽肤水	干性 中性 油性 所有肤质 国产 控油平衡 深层清洁 保湿 补水	控油平衡 洗面奶
拱辰 雪玉凝 系列 体验 套装 3件套44ml 水乳 体验套装	所有肤质 进口	所有肤质 体验套装
小甘菊 护手霜 保湿 补水 滋润 细腻 修复 冻疮 裂纹 脱皮 樱花 蜂蜜 芦荟 防冻裂 干燥 平滑 细纹 美肤 白嫩秋 冬季 护肤 手霜 套装 护手霜 手蜡 保湿补水 手霜套装	保湿 补水 国产 任何肤质	保湿补水 手霜套装
法国 黑钻 紫钻 口红 唇膏 末路 狂花 亚特兰蒂斯 生日 礼物 绝代 艳红 世佳 人口 世佳 黑钻	丝绒 中国大陆 红色	丝绒 口红
暖春 臻彩 宝石 唇膏 定镜面 镜子 口红 限量 女王 七夕 主图 礼盒 口红 芯+壳 备注 无备注 随机	欧美 润泽镜面 红色	润泽镜面 口红
官方 玻尿酸原液 美白 补水 保湿 收缩 毛孔 紧致 精华液 学生 玻尿酸原液	美白 紧致 收缩毛孔 精华液 保湿 补水	收缩毛孔 精华液
三八 妇女节 礼物 mac魅可 口红 礼盒 唇膏 套装 7支 礼盒 限量版 组合 套装 朋友 生日 礼物 限量 红管 西柚 唇部 打底 唇膏支套装	打底	打底 唇膏支套装
安瓶 精华 原液 面部 定妆 补水 保湿 影楼 抗皱 熬夜 寡肽 安瓶 1盒7支 同款	国产 任何肤质 提拉紧致 补水	提拉紧致 原液
黄金 精华液 玻尿酸 抗皱 原液 皱紧 淡化 细纹 法令 纹寡肽 原液 收缩 毛孔 2瓶 保湿补水	保湿 提拉紧致 补水 国产 任何肤质	保湿补水 精华液
安瓶 精华 大瓶 玻尿酸 烟酰胺 寡肽 原液 面部 精华水 补水 保湿 提亮 肤色 改善 黯黄 淡化 细纹 1发2瓶 1瓶 玻尿酸 1瓶 烟酰胺	国产 提亮肤色 保湿 抗皱 补水 任何肤质	提亮肤色 烟酰胺
佳琪 口红 掉色 不沾杯 持久 防水 滋润 保湿 脱色 学生 抖音 枫叶红 第二	持久 不沾杯 保湿 防水 滋润	不沾杯 口红
智妍 精华 面霜 黄金 面霜 干燥 细纹 皱纹 松弛 暗沉 效智 妍美肌 修颜乳	进口 任何肤质 干性 中性 混合性 提亮肤色 抗皱 修护 提拉紧致	提亮肤色 面霜
呼吸37 套装 苏秘 水乳霜 套装 女士 男士 护肤套装 惊喜 水分 水漾 套装 孕妇 可用 魔法 修复 水乳霜 祛痘 细致 毛孔 水乳霜套装	提拉紧致 进口 任何肤质	提拉紧致 水乳霜套装
网红 女士香水 持久 淡香 清晰 学生 香水 熏衣草	持久 淡香	持久 香水
套装 金致肌 补水 保湿 滋润 提拉 紧致 精华乳 面霜	国产 深层清洁 保湿 提拉紧致 补水 任何肤质 干性 油性 混合性	深层清洁 套装
资生堂 透亮 美白 保湿 柔肤乳 乳液 水润 触感 保湿美白	保湿 美白 国产 任何肤质	保湿美白 乳液
护肤套装 白松露 纯皙 光感 补水 高保 湿补 提亮 肤色 淡化 女士 化妆品 护肤 男女 通用 亮彩 面霜	所有肤质 控油平衡 细致毛孔 深层清洁 保湿 补水 国产	控油平衡 护肤套装
圣诞 礼遇 mac魅可 口红 小辣椒 雅色 牛血色 橘色	橘色	橘色 口红
第二 金装 套装 化妆品 吉沙 美白 祛斑霜 修复霜 日霜 晚霜	祛斑 美白 修复	美白 套装
莎迹 化妆品 实体 美容院 套盒 净基 精华素	国产 补水 任何肤质	补水 精华素
口红 哑光 雾面 新款 限量 辣椒红	哑光雾面 韩国 红色	哑光雾面 口红
毛孔 清透 化妆品 套装 深度 清洁 补水 保湿 平衡水 收缩 毛孔 爽肤水 清透 嗜喱.乳 化妆品套装	国产 控油平衡 细致毛孔 深层清洁 任何肤质	控油平衡 化妆品套装
澳洲 进口 羊胎素 绵羊油 滋养面霜 保湿 面霜 羊胎素 精华液 套装 网红 明星 同款 香粉 羊胎素 精华液 礼盒 保湿滋润 精华液套装	进口 保湿 滋润 补水 任何肤质	保湿滋润 精华液套装
暖春 口红 杨树林 男色 沙色 礼盒 套装 圣诞节 圆管 樱桃 红色 音乐 礼盒 礼盒套装	欧美 润泽镜面 红色	润泽镜面 礼盒套装
慕斯 绒情 口红 套装 哑光 雾面 茄焦 糖色 雅红 棕枫 橘棕 唇彩 遮瑕液 口红套装	雾面 遮瑕 慕斯 哑光	哑光 口红套装
智妍 系列 套装 组合 送礼 节日 保湿 补水 提拉 紧致 原生液 棕瓶 原生液 精华 面霜 晚霜 抗皱补水 系列套装	细致毛孔 抗皱 提拉紧致 补水 进口 任何肤质 干性 中性 油性	抗皱补水 系列套装
桂花 女士 淡香水 栀子 百合 熏衣草 学生 玫瑰 留香 玫瑰 玫瑰	玫瑰 通用 淡香 桂花	桂花 淡香水
小金管 蝴蝶结 口红 雾面 哑光 磁铁 链条 持久 脱色 雕花 唇膏 正红色 第二	哑光雾面 中国大陆 红色	哑光雾面 口红
口红 套装 日记 口红 保湿 滋润唇膏 小黑 红钻 迷醉 深莓色 口红套装	滋润 保湿	保湿 口红套装
韩纪 多肽 玻尿酸 紧致 提拉五件套 护肤品 套装 皮肤 补水 保湿 修护 洁面 水乳 bb霜 学生 女士 多肽 玻尿酸 礼盒 护肤品套装	国产 深层清洁 保湿 提拉紧致 补水 任何肤质	深层清洁 护肤品套装
特价 进口 品牌 清仓 不老林 男士 生发 精华液	进口 补水 任何肤质	补水 精华液
糖果 酸收缩 毛孔 精华液 黑头 痘印 修复 毛孔 粗大 控油 紧致 玻尿酸原液 男女 通用 棕瓶 瓶装 毛孔 收缩 精华液 保湿美白	任何肤质 敏感性 油性 混合性 国产 细致毛孔 保湿 美白 提拉紧致	保湿美白 精华液
玻尿酸 烟酰胺原液 虾青素 小安瓶 美白 淡化 精华液 斑补水 提亮 肤色 氧化 正品 男女 2盒14 改善 套装 元(立省 改善套装	提亮肤色 保湿 淡斑 补水 国产 任何肤质	提亮肤色 改善套装
日本 直邮 美白 保湿 精华 清新 保湿 修护 精油 美白精华 抗皱淡斑	进口 淡斑 抗皱 美白 提拉紧致 任何肤质	抗皱淡斑 精油
山茶花 补水 保湿 女士 护肤套装 化妆品 套装 4件套 洁面 精华水 精华露 凝霜 化妆品套装	进口 补水 任何肤质	补水 化妆品套装
梦幻 香皂 洗澡 洗手 肥皂 清洁 女士香水 沐浴 国货 梦幻 香皂 经典	户外 女士 清洁	清洁 女士香水
新生活 化妆品 韩国 新生活 化妆品 荟馨 纯净 橄榄 护肤 系列 套装 萌动 柔润 系列套装	混合性 补水 国产	补水 系列套装
红石榴 鲜活 水漾 洁面乳 柔肤水 修护 蜗牛霜 保湿 提亮 肤色	所有肤质 控油平衡 深层清洁 保湿 补水	控油平衡 洁面乳
2支 哑光 唇釉 丝绒 雾面 唇彩唇蜜 保湿 滋润 平价 小众 学生 口红 唇液 自由 搭配 专用 备注	丝绒	丝绒 唇液
圣诞 礼物 女友 ford汤姆福特 口红 礼盒 黑管 白管 套装 唇膏 黑管 礼盒 白管套装	中国大陆	中国大陆 白管套装
古龙 男士香水 持久 淡香 清新 男人 女士 香氛 摩登 小姐 金色	金色 持久 淡香	持久 香氛
美国 进口 男女 帝皇 蜂姿 赋研 日霜 面霜 中性 干性	进口	进口 面霜
泰国 玫瑰 精华 爆水 滋润 保湿 面霜 补充 肌肤 流失 水分 提亮 肤色 滋润乳液 敏感 适用 玫瑰 精华 爆水 面霜	进口 任何肤质 提亮肤色 保湿 滋润 补水	提亮肤色 面霜
巴巴 爸爸 唇膏 口红 保湿 滋润 哑光 不易 粘杯 学生 口红 复古 姨妈	哑光雾面 橘色 中国大陆	哑光雾面 口红
网红 亮粉 流沙 少女 反转 巴黎 蓝风铃 牛奶 学生 平价 香水 女士 持久 淡香 私家 小众_柏林 少女	东方香调 女士 日常	东方香调 香水
素颜霜 维他 面霜 蓝色 魔法 精华 药丸 安瓶 精华	提亮肤色 保湿 滋润 进口 任何肤质	提亮肤色 面霜
女士 护肤 彩妆套装 礼盒 学者 化妆品 组合 裸妆 淡妆 葡萄籽 套装 气垫 眉笔 眼线 睫毛膏 眼影 口红	任何肤质 国产 裸妆	裸妆 彩妆套装
玻尿酸 烟酰胺 大安瓶 原液 精华液 爽肤水 面膜 补水 保湿 美白 祛痘 淡印 斑抗皱 紧致 收缩 毛孔 面膜 淡斑美白	国产 任何肤质 干性 油性 混合性 淡斑 舒缓镇静 美白 补水	淡斑美白 面膜
唇釉 镜面 口红 掉色 限量版 葡萄 紫02 成熟 樱桃 滋润	镜面 滋润 韩国	镜面 口红
至真 彩唇膏 耀眼 光彩 双唇 持久 显色	韩国 自然 红色	自然 彩唇膏
盒装 富勒 烯赋活 精华液 富勒烯 原液 舰旗店	混合性 进口 补水	补水 精华液
专柜 正品 亲亲 黑管 唇膏 口红 杨洋 女友 生日 礼物 节日 情人	泰国	泰国 口红
荷花 保湿 护肤品 呼吸 水乳套装 收缩 细致 毛孔 化妆品 男女 荷花 乳+ 洁面 面膜贴 保湿霜	控油平衡 细致毛孔 深层清洁 补水 国产 任何肤质	控油平衡 水乳套装
网红 懒人 素颜霜 水嫩 隔离霜 气垫霜 保湿 隔离 遮瑕 粉底液 bb霜 咖啡色 清新	国产 保湿 任何肤质	保湿 素颜霜
情人节 礼物 皱纹 克星 肽抗皱 精华液 玻尿酸 原液 提拉 致祛 抬头 纹^六胜肽 精华液 面膜 眼贴膜	国产 提亮肤色 提拉紧致 任何肤质	提亮肤色 面膜
国内 专柜 晶灵 系列 洁面 面霜 精华 雪晶 灵洁 泡沫 保湿补水	保湿 补水 进口 任何肤质	保湿补水 面霜
柑橘 平滑 细肤 舒缓 晚霜 美容院	进口 任何肤质 舒缓镇静	舒缓镇静 晚霜
彩妆 化妆品 套装 套盒 组合 学者 新手 学生 淡妆 底妆 遮瑕 隔离 清新 自然 化妆品套装	国产 自然 遮瑕 任何肤质 隔离	遮瑕 化妆品套装
套装 弹力 蛋白 凝时 紧致 保湿 补水 淡化 细纹 眼霜 抗皱 化妆品 眼霜 护肤品 套装 礼盒 官方 旗舰 正品 面霜 保湿补水 护肤品套装	国产 任何肤质 细致毛孔 保湿 提拉紧致 补水	保湿补水 护肤品套装
情人节 礼物 镜面 唇釉 滋润 保湿 脱色 口红 可爱 学生 唇彩唇蜜 网红 染唇液 砖红色	哑光雾面 中国大陆 红色	哑光雾面 口红
迷你 口红 显色 脱色 自然 滋润 衬托 肤色 鱼姬	显色 自然 滋润	显色 口红
专柜 正品 包邮 包税 口红 不易 掉色 女士 唇彩 可可 小姐 唇膏 女友 礼物 可可色	欧美 橘色	橘色 口红
香港 地区 直发 黑金 唇膏 口红 七夕		口红
素颜霜 套装 裸妆 遮瑕 隔离 懒人霜 美白 防水 增白 控油 防晒 汗小 麦色 男女 学生 素颜霜套装	提亮肤色 保湿 提拉紧致 补水 国产 油性	提亮肤色 素颜霜套装
正常 发货 2送1 女士香水 持久 淡香 网红 学生 少女 小样 清新 玫瑰 自然 栀子花 桂花 礼盒装 粉漾 年华	花果香调 女士 日常	花果香调 女士香水
香水 杨树林 黑色 飘茗 黑鸦片 反转 巴黎 女士香水 反转 巴黎	职场 日常 通用 花香调	花香调 香水
玻尿酸 水光 精华 原液 补水 保湿 滋养 水润 提亮 肤色 精华液 保湿补水	保湿 补水 国产 油性	保湿补水 精华液
美国 直邮 贾斯汀 比伯 钥匙 女士香水	职场 休闲 约会 日常 花果香调 女士	花果香调 女士香水
四季美人 玻尿酸原液 水疗 逆龄 化妆品 套装 补水 保湿 收缩 护肤品 5/面奶 乳液 保湿补水 化妆品套装	保湿 提拉紧致 补水 国产 任何肤质	保湿补水 化妆品套装
雕花 口红 摩登 戒指 丝绒 雾面 滋润 口红 正红色 不沾杯 脱妆^05 熟透 番茄	丝绒 红色	丝绒 口红
情人节 礼物 嫩肤 补水 保湿 玻尿酸原液 淡化 红血丝 皱纹 收缩 毛孔 精华液 洗面奶 2支 面膜 2片 补水美白	美白 补水 国产 任何肤质	补水美白 面膜
补水霜 高保 滋润 乳液面霜 学生 滋润 保湿 补水 洗面奶 银杏 柔嫩 补水霜 补水美白	美白 补水 国产 干性	补水美白 洗面奶
男士 香膏 固体香水 持久 淡香 清新 古龙 大吉岭茶 大地 蔚蓝 口袋 男香 专用 摩登 木质 礼盒	男士 花香调 日常	花香调 香膏
美白 祛斑霜 哈尔滨 1号 2号 套装 亮肤 王专柜 精华液 单购 2号套装	祛斑 亮肤 美白 精华液	精华液 2号套装
美白霜 妈妈 擦脸油 补水 保湿 精华 面霜 素颜霜 护肤品 套装 面部 滋润 控油 中老年 护肤套装 红石榴 补水 护肤品套装	国产 舒缓镇静 提拉紧致 补水 任何肤质	舒缓镇静 护肤品套装
黑头 撕拉 面膜 女士 黑头 粉刺 黑鼻头 撕拉式 清洁 收缩 毛孔 紧致 肌肤 健康 肌肤	国产 紧致 收缩毛孔 细致毛孔 清洁 任何肤质	收缩毛孔 面膜
美白 芦荟胶 面霜 痘印 修复 芦荟膏 免洗 面膜 男女 补水 超值装 芦荟胶	进口 任何肤质 抗痘	抗痘 面膜
汤姆福特 口红 白管 口红 烈焰 幻魅 唇膏 黑管 姜红色	欧美 红色	红色 口红
安尚秀 光耀 感定 制礼盒 光耀 聚液 光耀 钻感 精华霜 小灯 泡保 面部精华 套盒 光耀 感定 制礼盒 套装	国产 任何肤质 提亮肤色 保湿 补水	提亮肤色 套装
韩国 磁吸 口红 黑方 口红 哑光 丝绒 柔滑 显色 雾面 质感 滋润 玫瑰 豆沙色	哑光雾面 韩国 红色	哑光雾面 口红
竹林堂 蚕丝面膜 紫色 提拉 面膜 5片 蓝色 补水 保湿 5片	国产 保湿 蓝色 任何肤质 紫色 补水	补水 面膜
美白霜 妈妈 擦脸油 补水 保湿 精华 面霜 素颜霜 护肤品 套装 面部 滋润 控油 中老年 护肤套装 清爽 绿茶 植物 护肤品套装	国产 舒缓镇静 提拉紧致 补水 任何肤质	舒缓镇静 护肤品套装
口红 臻致 丝绒 哑光 唇釉 黑管 桃粉色	欧美 自然 红色	自然 口红
女士 乳液面霜 脸部 滋润 眼霜 美容 日霜 晚霜 保湿 水蛋 水凝 保湿 清爽 柔肤水	滋润 国产 任何肤质	滋润 眼霜
文克莱 真理 男士 淡香水	男士 淡香 日常 约会 休闲 职场	淡香 淡香水
邂逅 柔情 清新 活力 淡香水 黄绿粉 橙色 女士香水 小姐 淡香	户外 约会 日常 女士 花香调	花香调 淡香水
韩国 水乳套装 玻尿酸 套盒 收缩 毛孔 补水 保湿 提亮 修复 维生素 活力 水乳套装 保湿补水	任何肤质 敏感性 保湿 补水 进口	保湿补水 水乳套装
口红 掉色 防水 保湿 不沾杯 咬唇妆 学生 套装 珊瑚 胭脂 经典 红果 冻色 亮粉 口红 学生套装	防水 不沾杯 保湿	不沾杯 学生套装
小羊皮 口红 定制 礼盒 生日 圣诞 情人 礼物 颜色 备注 自选 礼盒 天长地久	泰国	泰国 口红
思妍 靓丽白 红雪润 透红 化妆品 护肤品 套装 专柜 正品 日霜 护肤品套装	国产 补水 任何肤质	补水 护肤品套装
唇线笔 防水 持久 脱色 学者 懒人 勾线 口红 神器 自动 描唇 豆沙色	红色	红色 口红
护肤品 套装 植物 酵素 补水 保湿 滋养 细腻 洗面奶 柔肤水 面部 护理 套组 礼盒 化妆品 净肤亮 颜粉 泥膜 护肤品套装	国产 细致毛孔 深层清洁 舒缓镇静 补水 任何肤质	深层清洁 护肤品套装
护肤品 套装 授权 旗舰 官方 水凝 悦泽 桃花 系列 水乳 补水 保湿 提亮 肤色 洁面 护肤品套装	国产 保湿 中性	保湿 护肤品套装
桂花 玫瑰 茉莉 香水 香水 花香 香水 2发3 桂花 香型	通用 花香调 聚会 休闲 日常	花香调 香水
清颜 修护 精华乳 保湿补水	保湿 补水 进口 任何肤质	保湿补水 精华乳
凝时 鲜颜 套装 补水 保湿 提拉 紧致 深层 滋养 淡化 细纹 官方 旗舰 正品 护肤 化妆品 礼盒 组合 套装 洗面奶 冰肌水 乳液 精华液 鲜颜套装	国产 深层清洁 保湿 提拉紧致 补水 干性 中性 油性 混合性	深层清洁 鲜颜套装
益生菌 水乳套装 益生菌 平衡水 益生菌 平衡乳液 韩国进口 清爽 控油 补水 保湿 护肤品 敏感肌 可用	进口 任何肤质 敏感性 油性 混合性 控油平衡 细致毛孔 保湿 补水	控油平衡 水乳套装
哑光唇膏 土色 口红 学生 菲律宾 小众 品牌	哑光	哑光 口红
专营 优品 黑金 焕采 水光 黑面膜 补水 保湿 吸黑 深层 清洁 毛孔 紧致	提亮肤色 保湿 提拉紧致 进口 任何肤质	提亮肤色 黑面膜
素颜 护肤品 套装 女秋 补水 保湿 水乳液 男士 学生 化妆品 6件套 气垫 自然色 保湿补水 化妆品6件套	保湿 补水 国产 任何肤质	保湿补水 化妆品6件套
京选 百花 霜弹 水嫩 滋养霜 嫩肤 嫩白 面霜 乳液 补水 保湿 护脸霜 莱蔻 补水 保湿面膜 保湿补水	保湿 补水 国产 任何肤质	保湿补水 面霜
胡萝卜素 星空 闪亮 佳琪 推荐 砖红 口红 哑光 掉色 学生 唇膏 口红 孕妇 口红 滋润 口红 自然 元气色	润泽镜面 中国大陆 红色	润泽镜面 口红
颜蔻 冷泉 调理 舒缓 套装 专柜 舒敏 补水 保湿凝霜 清爽 修复 滋润 五件套 水凝霜 保湿补水 滋润五件套	保湿 补水 国产 任何肤质	保湿补水 滋润五件套
系列 洁面乳 爽肤水 乳液 日霜 晚霜 补水 保湿 滋润 提亮 肤色 化妆品 护肤品 包装 包邮 亮采 滋润乳 日霜	国产 提亮肤色 细致毛孔 保湿 补水 任何肤质 干性 中性 油性	提亮肤色 乳液
口红 星钻 小灯 管礼 盒装 包装口 红豆 沙色 口红 正红色 覆盆子色	裸色豆沙色 闪光珠光 中国大陆	闪光珠光 口红
2件 星动 臻色 金钻 口红 持久 显色 保湿 不易 脱色 新品 格兰特 夫人 大都 联名	显色 持久 中国大陆 保湿	持久 口红
京东 泰国 美国 魅可(mac) 子弹头 水漾 润泽 唇膏 口红 网红 学生 全色号 珊瑚 橘色	欧美 哑光雾面	哑光雾面 口红
蜂毒 逆龄 青春 面膜 2盒135 新款 1盒 带盒 第三	补水 国产 任何肤质	补水 面膜
化妆品 护肤套装 礼盒 水漾 芯肌 洁面膏 透润 乳+ 精华 透润霜 滋润型 保湿补水	保湿 补水 国产 任何肤质	保湿补水 护肤套装
口红 挚爱 哑光唇膏 雾面 哑光 姨妈	欧美 哑光雾面 红色	哑光雾面 口红
韩国 烟酰胺 水乳 洁面慕斯 套装 纯然 匀透 精华 保湿 提亮 肤色 玻尿酸原液 嫩白 爽肤 烟酰胺 水乳 保湿补水 洁面慕斯套装	保湿 补水 进口 任何肤质	保湿补水 洁面慕斯套装
补水 舒润 系列 护肤品 套装 补水 保湿 滋润 肌肤 控油 清爽 提亮 肤色 五件套 水+ 乳+ 洁面 眼霜 精华 护肤品套装	国产 控油平衡 细致毛孔 保湿 补水 任何肤质	控油平衡 护肤品套装
口红 钻石 口红 保湿 滋润唇膏 不易 掉色 哑光 雾面 唇釉 显色 施华洛世奇 水晶 元素 平价 口红 裸米色	中国大陆 红色	红色 口红
韩国 得鲜 亚麻籽 水乳 面霜 套装 保湿 套盒 男女 补水 护肤 正品 亚麻籽 套盒 面霜套装	进口 补水 任何肤质	补水 面霜套装
烈焰 蓝金 唇膏 口红 烈艳 蓝金 哑光 新色 开运红	哑光	哑光 口红
星辰 口红 杨树 鎏金 口红 厘子 色彩 非雕花 口红 选择 古红		口红
新年 礼物 禁忌 绝版 回归 非洲 圣诞 口红 唇膏 红丝绒 小羊皮 圣诞 限量 石榴红 玫瑰 金管	欧美 丝绒 红色	丝绒 口红
专方 深层 保湿 面霜 补水 保湿 深层 滋润 润肤霜 保湿滋润	国产 干性 保湿 滋润 补水	保湿滋润 面霜
情人节 礼物 抖音 雅邦 黑管 口红 持久 保湿 护唇 不易 脱色 烂番 茄色 颜九 枫叶红	哑光雾面 中国大陆 红色	哑光雾面 口红
子弹头 多色 圆管 口红 抖音 南瓜 色西 柚色 滋润 保湿 口红 南瓜色	保湿 多色 滋润	滋润 口红
黑管 口红 礼盒 情人节 七夕 生日 礼物 白管 汤姆福特 白管 奶油 西柚色 真花	中国大陆	中国大陆 口红
口红 限量版 红管 哑光礼 盒装 套装 红管	欧美 红色	红色 套装
钻石 闪耀 钻石 口红 滋润 丝绒 哑光 持久 掉色 不沾杯 润唇膏 学生 朱砂红 浆果色	持久 女士 不沾杯 丝绒 哑光 润唇 滋润	不沾杯 口红
西密语 氨基酸 洁面 乳膏	洁面	洁面 乳膏
新芙 灵霜 套装 祛螨 男女 祛痘膏 青春痘 黑头 粉刺 灵霜 洁面乳 洗面奶 灵霜套装	国产 保湿 任何肤质	保湿 灵霜套装
植物智慧 雅格 丽白 女士 护肤品 套装 橄榄 鲜活 弹润秋 化妆品 套装 爽肤水 乳液 护肤品套装	控油平衡 保湿 提拉紧致 补水 国产 任何肤质	控油平衡 护肤品套装
mac魅可 磨砂 系列 新款 雾面 丝绒 哑光尤雾 子弹头 口红 磨砂 樱花 桃粉色	欧美 哑光雾面 红色	哑光雾面 口红
香水 宣言 女士 黑鸦片 反转 巴黎 巴黎恋人 女士香水 经典 巴黎 淡香水 黑鸦片 女士香水	送礼 情趣 职场 日常 通用 花香调	花香调 香水
专营 优选 女士 口红 护唇膏 持久 掉色 滋润 保水 网红 生日 礼物 不易 脱色 持久 提升 气色 孕妇 可用 梅子色	持久 滋润 提升气色	提升气色 口红
舒缓 控油 凝露 控油 保湿 抑痘 减少 油脂 分泌 修护 舒缓 平衡 清痘 补水 保湿	控油平衡 保湿 舒缓镇静 补水 国产 任何肤质 油性	控油平衡 凝露
国内 专柜 真爱 香水 口红 套装 真爱 香氛 花香 女士 持久 口红套装	女士 花香调 日常	花香调 口红套装
水无色 润唇膏 滋润 保湿 口红 唇膏 防日 滋润唇膏 蓝莓	保湿 润唇 滋润	润唇 口红
versace(范思哲) 臻挚 晶钻 明亮 香恋 水晶 粉钻 幻影 金钻 水晶 女士香水 女士香水 黑水晶 女香 正装	休闲 日常 女士 花香调	花香调 女士香水
莹肌 保湿 护肤套装 面部 护肤 化妆品 套装 补水洗面奶 爽肤水 乳液面霜 学生 正品 专柜 热卖 洁面乳 乳液 保湿补水 化妆品套装	保湿 补水 国产 任何肤质	保湿补水 化妆品套装
专柜 直供 口红 唇膏 羊皮 高定 丝绒 生日 礼物 棕调 正红	欧美 哑光雾面 红色	哑光雾面 口红
韩国 直邮 套装 小样 试用 顺行 洗面奶 洁面乳 人参 水乳 修护 面膜 旅行 套装 旅行装 乳液 保湿补水 面膜旅行套装	进口 细致毛孔 保湿 补水 任何肤质 干性 油性 混合性	保湿补水 面膜旅行套装
法国 植蔻 化妆品 专柜 美容院 冻干粉	国产 补水 任何肤质	补水 冻干粉
口红 套装 2支 大理石 哑光口红 女久 保湿 国货 平价 小众 豆沙 唇釉 唇膏 学生 高贵 红+ 厘子 口红套装	哑光 保湿	哑光 口红套装
七夕 情人节 礼物 烈艳 蓝金 红管 口红 8套盒 香2 2四 品牌	欧美	欧美 口红
魅可(m.a.c) 子弹头 口红 女士 唇膏 持久 显色 棕调 砖红	欧美 丝绒 红色	丝绒 口红
蓓爱 炫彩 护唇膏 润唇膏 波普风 保湿 滋润 显色 丰润 蜜糖 小裸丽	显色 中国大陆 保湿 润唇 滋润	润唇 润唇膏
nars纳斯 丝绒 唇膏笔 限量 新色	欧美 丝绒	丝绒 唇膏笔
韩国 精华液 套装 自生秘 套盒 自生秘 修复 礼盒 循环 秘贴 肌底 精华 密贴 精华 再生 秘贴 再生 秘贴 精华液 套装 唇膏 抗皱保湿 精华液件套装	进口 保湿 抗皱 提拉紧致 补水 任何肤质	抗皱保湿 精华液件套装
糖果 套盒 贝壳 彩妆组合 口红 睫毛膏 眼影 显色 晕染 滋润 持久	显色 持久 滋润	显色 口红
抢购 李佳琦 推荐 同款 国货 彩妆 口红 掉色 不沾杯 润唇膏 唇釉 唇彩 姨妈色	不沾杯 润唇	不沾杯 口红
男士 护肤品 套装 水乳 化妆品 补水 保湿 控油 学生 男士 清爽 平衡 套装 护肤品套装	国产 控油平衡 保湿 抗痘 补水 任何肤质	控油平衡 护肤品套装
抖音 网红 同款 口红 小众 品牌 李佳琦 推荐 口红 学生 白平价 替代 粉蔷薇色		口红
潘姿 冰巧 美斯 润泽 柔肤 美颜 六合 套装 美斯 美百 护肤品 套装 单瓶 日霜 保湿补水 护肤品套装	混合性 保湿 提拉紧致 补水 国产	保湿补水 护肤品套装
新玛萨 专柜 化妆品 开运 脸术 组合 保湿补水 套装	所有肤质 保湿 补水 国产	保湿补水 套装
唇釉 雾面 染唇液 唇蜜 唇彩 持久 口红 分类 唇釉 学生 少女平价 魅红	持久 雾面	雾面 唇釉
口红 唇釉 唇彩 润唇膏 不易沾杯 防水 滋润 持久 保湿 不易 掉色 女士 淡粉	中国大陆 自然	自然 口红
官网 现货 欧束 化妆品 正品 护肤套装 补水 保湿 妆前乳 水乳 乳液 洗面奶 醒肤水 凝润 恒久 气垫 修颜霜 自然色 醒肤水 平衡乳	国产 控油平衡 保湿 修护 补水 任何肤质	控油平衡 护肤套装
玛采儿 平价 替代 星空 丝绒 滋润 口红 网红 学生 高颜值 枫叶红 唇膏 豆沙色 星空 口红	丝绒	丝绒 口红
裸纱 玲珑 柔情 女士 淡香水 保税 发货 巴宝莉 香水 裸纱 玲珑	送礼 休闲 约会 日常 清新香调 女士	清新香调 香水
孕妇 口红 天然 可用 小样 防水 安全 专用 红橙色 哑光	防水 哑光	防水 口红
美人符 富勒 胎盘素 精华液 羊胎素 胶囊 玻尿酸原液 胶囊 逆龄 小鸡腿 提亮 肤色 收缩 毛孔 改善 沉紧 胶原蛋白 女士 3盒 修复 元/盒	提亮肤色 国产 任何肤质	提亮肤色 精华液
套装 金缕梅 控油 祛痘 收缩 毛孔 黑头 洁面膏 洗面奶 收敛水 润肤乳 套装 清爽 油腻 男女 控油 祛痘 凝胶 润肤乳套装	油性 混合性 控油平衡 抗痘 国产	控油平衡 润肤乳套装
日本 蛇毒 电解 水乳液 净颜 柔肤乳 抗氧化美白	细致毛孔 抗氧化 美白 提拉紧致 进口 任何肤质	抗氧化美白 水乳液
三八 妇女节 礼物 先锋 男士 香水 木质 奇香 清新 海洋 香^浓香型	运动 休闲 约会 日常 海洋香调 男士	海洋香调 香水
婴儿 粉嫩霜 裸妆 遮瑕 保湿 补水 滋润 懒人霜 隔离 素颜霜 面霜	进口 补水 任何肤质	补水 面霜
雾面 哑光 丝绒 口红 高颜值 辣椒 豆沙色 唇膏 学生 激烈 红色	泰国 丝绒	丝绒 口红
甘油 保湿露 3瓶装 补水 滋润 舒缓 全身 润肤水 啫喱 乳液 国货 老牌 护肤品 保湿滋润	国产 保湿 滋润 补水 干性 中性 油性 混合性	保湿滋润 乳液
新款 6支装 口红 套装 多色 持久 哑光 脱色 橘南 瓜色 口红 唇膏. 日落 珠光 口红套装	哑光雾面 中国大陆	哑光雾面 口红套装
巴宝莉 女士香水 绯女	女士 日常	女士 女士香水
专柜 货源 小金条 口红 哑光 雾面 唇膏 音乐 玫瑰 礼盒 情人节 生日 礼物 女友 小金条 音乐 礼盒	欧美 哑光雾面 红色	哑光雾面 口红
小黑 唇膏 滋润 唇纹 孕妇 可用 口红 生日 礼物	欧美 滋润	滋润 口红
芦荟 护肤 化妆品 套装 芦荟 鲜补 水面 套装 补水 保湿 面奶 水乳霜 面奶 乳+霜 精华 眼霜 赠品 化妆品套装	国产 补水 任何肤质	补水 化妆品套装
雪兰 朵美 容院 专柜 化妆品 修护 保湿 深层 滋养 精华 乳霜 面膜 女士 护肤品 雪兰 玫瑰花	滋养 玫瑰 修护 保湿	修护 面膜
佰草世家 素颜霜 男士 学生 少女 合一 裸妆 专用 遮瑕 隔离 护肤品	国产 任何肤质 舒缓镇静	舒缓镇静 素颜霜
分装瓶 化妆品 喷雾瓶 护肤品 旅行 喷瓶 大容量 空瓶 喷壶 颜色 随机 压瓶	任何肤质 喷雾 国产	喷雾 喷瓶
一枝春 美白霜 补水 保湿 提亮 肤色 滋养 嫩肤 平衡水 面霜 护肤品	进口 补水 任何肤质	补水 面霜
专柜 正品 唇膏 缎采 唇膏	欧美 自然 红色	自然 唇膏
美白霜 女士 去除 雀斑 遗传斑 老人 年斑 嗮斑 辐射斑 淡化 斑点 黑色素 保湿 补水 护肤 化妆品 素颜 元素 面霜 晚霜	提亮肤色 淡斑 美白 补水 任何肤质 敏感性 干性 中性 国产	提亮肤色 面霜
新款 品牌 口红 多色 持久 哑光 珠光裸 橘南 瓜色 口红 套装 国货 彩妆 绒光 哑光 口红套装	多色 持久 哑光 珠光	持久 口红套装
小安瓶 芦荟 舒肌 保湿 女士 护肤品 套装 护肤礼盒 化妆品 护肤套装 洗面奶 柔肤水 保湿霜 护肤品套装	国产 保湿 任何肤质	保湿 护肤品套装
